Name,xMins,GW1,GW2,GW3,GW4,GW5,Total,xMins/£M,Elite%
M.Salah,89,89,87,85,83,82,426,5.9,56.8%
Palmer,89,89,87,86,81,80,423,8.1,53.0%
Haaland,89,89,85,80,79,80,413,5.9,19.6%
Marmoush,77,77,73,72,72,70,364,8.6,14.0%
Watkins,85,85,82,85,85,81,418,9.3,14.3%
B.Fernandes,90,90,88,86,85,83,432,9.6,13.3%
Wirtz,85,85,81,78,76,77,397,9.3,33.6%
Saka,89,89,83,83,80,76,411,8.2,15.6%
Isak,87,87,83,80,79,80,409,7.8,28.6%
Eze,88,88,80,80,78,81,407,10.9,9.1%
Solanke,80,80,77,78,74,75,384,10.2,12.8%
Rogers,89,89,84,84,85,81,423,12.1,25.4%
Gibbs-White,89,89,82,83,80,79,413,11.0,4.7%
Bowen,88,88,86,82,84,82,422,10.6,19.8%
Wood,81,81,74,76,73,74,378,10.1,16.3%
Sarr,83,83,81,78,77,74,393,12.1,2.2%
Neto,84,84,80,79,80,74,397,11.3,4.4%
Gakpo,68,68,66,62,62,58,316,8.4,3.9%
Virgil,88,88,89,86,86,77,426,14.2,22.7%
Frimpong,78,78,78,74,72,72,374,12.5,26.2%
Mitoma,83,83,81,80,77,76,397,12.2,5.8%
Semenyo,87,87,84,80,79,78,408,11.7,5.1%
Ødegaard,83,83,77,76,75,71,382,9.6,3.3%
Tielemans,84,84,79,82,80,78,403,13.4,1.6%
Ndiaye,79,79,76,76,75,72,378,11.6,12.3%
Evanilson,84,84,78,75,79,73,389,11.1,2.5%
Mbeumo,79,79,78,79,72,72,380,9.5,17.0%
Mateta,69,69,67,68,65,66,335,8.9,6.3%
Welbeck,76,76,73,74,72,68,363,11.2,7.8%
Murillo,88,88,87,84,83,82,424,15.4,4.6%
Enzo,89,89,89,84,82,84,428,13.2,4.1%
Muñoz,88,88,88,86,85,82,429,15.6,8.6%
Strand Larsen,81,81,79,75,76,75,386,11.9,5.9%
Mac Allister,84,84,79,73,76,73,385,11.8,1.5%
Schade,77,77,76,74,75,72,374,10.7,2.0%
A.Becker,93,93,89,86,84,87,439,16.0,10.8%
Rice,84,84,75,81,75,74,389,12.0,7.4%
Pedro Porro,76,76,82,75,80,74,387,14.1,10.9%
Bruno G.,89,89,86,86,83,84,428,13.2,1.4%
Lacroix,90,90,86,84,86,82,428,17.1,1.0%
Cunha,72,72,74,71,68,68,353,8.8,10.7%
Raya,92,92,91,91,90,93,457,16.6,18.2%
Rodrigo,85,85,86,84,78,79,412,12.7,1.6%
Anderson,84,84,86,82,81,79,412,15.0,3.9%
L.Paquetá,79,79,75,71,68,70,363,12.1,1.0%
Iwobi,82,82,79,77,76,74,388,11.9,1.4%
Damsgaard,85,85,79,79,77,78,398,13.3,1.2%
Joelinton,88,88,82,80,79,79,408,13.6,0.4%
Kudus,74,74,71,67,67,63,342,10.5,25.8%
Sánchez,93,93,92,92,89,87,453,18.1,15.2%
Tarkowski,93,93,89,87,87,85,441,16.0,4.8%
N.Williams,88,88,84,83,86,80,421,16.8,3.5%
Milenković,89,89,88,88,85,87,437,15.9,8.7%
Konaté,84,84,80,75,75,75,389,14.1,2.8%
Colwill,87,87,84,82,81,82,416,16.6,5.5%
Ederson M.,92,92,89,85,89,87,442,16.1,3.7%
Caicedo,88,88,87,84,84,82,425,15.5,7.3%
Malen,60,60,60,59,57,56,292,10.6,2.4%
Cucurella,84,84,81,78,79,77,399,13.3,19.1%
Andersen,92,92,87,87,84,85,435,19.3,1.2%
Alcaraz,79,79,77,76,77,71,380,13.8,0.3%
Munetsi,84,84,82,79,79,83,407,14.8,0.1%
Wissa,59,59,65,65,60,61,310,8.3,7.1%
Richards,88,88,82,78,82,82,412,18.3,0.8%
Vicario,93,93,93,93,93,91,463,18.5,3.5%
Schär,89,89,87,79,79,83,417,15.2,2.3%
Gabriel,76,76,81,84,80,79,400,13.3,22.9%
Wilson,70,70,66,60,62,53,311,11.3,1.3%
Kluivert,73,73,69,61,59,62,324,9.3,4.8%
Guéhi,92,92,89,87,89,84,441,19.6,13.3%
Saliba,89,89,88,88,86,82,433,14.4,14.0%
Sels,94,94,92,92,89,90,457,18.3,17.9%
McNeil,76,76,74,73,73,70,366,12.2,0.9%
Tonali,88,88,85,81,84,79,417,15.2,2.4%
Gyökeres,44,44,45,49,58,59,255,5.7,24.2%
Hall,85,85,86,84,83,80,418,15.2,2.8%
Leno,93,93,92,91,91,92,459,18.4,1.7%
Gordon,64,64,63,61,61,61,310,8.3,3.0%
Collins,91,91,89,85,82,84,431,17.2,1.7%
Pickford,92,92,92,91,89,89,453,16.5,12.3%
Robinson,91,91,86,84,80,83,424,17.0,6.4%
Areola,94,94,91,91,91,90,457,20.3,5.9%
Kelleher,93,93,93,90,91,90,457,20.3,32.2%
Romero,90,90,87,83,81,77,418,16.7,1.7%
Reijnders,68,68,72,70,67,63,340,12.4,4.8%
Gomes,89,89,86,84,83,81,423,15.4,0.1%
Gana,89,89,88,82,79,82,420,15.3,0.1%
Verbruggen,94,94,92,91,90,89,456,20.3,7.0%
Perri,94,94,92,93,92,90,461,20.5,0.3%
Konsa,89,89,90,89,86,86,440,19.6,23.5%
Georginio,61,61,62,57,55,51,286,9.5,0.4%
Petrović,90,90,91,89,88,88,446,19.8,4.7%
Branthwaite,90,90,85,83,84,82,424,15.4,1.9%
Henderson,91,91,89,86,86,80,432,17.3,3.4%
José Sá,94,94,93,91,94,91,463,20.6,2.5%
Hudson-Odoi,71,71,72,66,68,64,341,11.4,1.9%
Adingra,76,76,73,75,72,67,363,13.2,2.8%
Cash,81,81,79,73,69,75,377,16.8,1.7%
Aït-Nouri,63,63,60,59,66,58,306,10.2,23.9%
Estève,90,90,90,90,88,85,443,22.1,11.8%
Baleba,86,86,80,79,79,77,401,16.0,4.5%
Wan-Bissaka,88,88,87,84,84,81,424,18.8,31.6%
Anthony,76,76,73,68,66,71,354,12.9,0.1%
Tel,55,55,52,51,51,52,261,8.0,0.2%
Dorgu,80,80,77,74,75,71,377,16.8,5.0%
Mitchell,78,78,79,78,72,69,376,15.0,1.0%
Van den Berg,90,90,88,86,83,80,427,19.0,0.4%
Thiago,55,55,50,57,52,57,271,9.0,1.0%
Minteh,63,63,58,59,60,59,299,10.0,1.2%
Szoboszlai,67,67,49,49,47,44,256,7.9,1.8%
Kilman,92,92,86,87,81,84,430,19.1,0.4%
Aina,89,89,90,87,85,79,430,17.2,17.8%
Senesi,86,86,83,79,80,81,409,18.2,0.7%
Tavernier,64,64,61,61,56,56,298,10.8,0.4%
Ekitiké,43,43,46,46,48,41,224,5.3,5.0%
Gvardiol,67,67,69,67,67,61,331,11.0,17.3%
Cullen,91,91,87,89,87,87,441,17.6,0.1%
Piroe,69,69,67,62,60,59,317,11.5,3.5%
Lewis-Skelly,77,77,76,75,70,70,368,13.4,5.6%
Todibo,89,89,84,82,82,83,420,18.7,0.1%
Zabarnyi,90,90,88,84,86,80,428,17.1,0.5%
Mykolenko,89,89,83,84,81,80,417,16.7,4.5%
Xhaka,87,87,86,84,82,82,421,16.8,2.1%
Garner,83,83,77,79,75,75,389,15.6,0.1%
Onana,88,44,86,91,91,92,404,16.2,0.1%
Roefs,88,88,88,89,84,83,432,19.2,0.1%
Flemming,71,71,70,65,66,65,337,12.3,0.2%
Truffert,88,88,86,84,83,82,423,18.8,1.3%
James,66,66,63,67,64,66,326,11.9,0.9%
João Pedro,69,69,50,51,49,47,266,7.1,52.5%
Muniz,63,63,57,55,50,50,275,10.0,2.5%
Ndoye,63,63,64,67,57,62,313,10.4,0.3%
Kerkez,69,69,65,62,68,58,322,10.7,10.7%
Füllkrug,60,60,63,63,63,57,306,10.2,1.9%
Foden,45,45,46,50,44,43,228,5.7,3.2%
Pope,83,83,82,79,78,79,401,16.0,3.9%
Fofana,76,76,73,70,66,71,356,15.8,0.3%
J.Ramsey,61,61,60,58,59,58,296,10.8,0.6%
Rúben,74,74,73,76,69,69,361,13.1,2.4%
Kamara,83,83,83,78,76,80,400,16.0,0.2%
Carvalho,57,57,50,52,56,56,271,10.8,0.3%
Agbadou,91,91,85,80,80,84,420,18.7,0.4%
E.Le Fée,70,70,73,68,66,63,340,13.6,1.2%
Bassey,90,90,86,87,86,79,428,19.0,0.4%
Souček,71,71,71,70,65,65,342,11.4,0.9%
Van Hecke,87,87,87,81,83,79,417,18.5,1.2%
Lukić,80,80,76,82,75,72,385,15.4,0.1%
De Cuyper,67,67,65,66,63,63,324,14.4,8.2%
Ballard,90,90,87,83,80,82,422,18.8,0.3%
Mayenda,67,67,62,64,58,58,309,11.2,0.5%
Martinez,0,0,92,92,91,91,366,14.6,0.5%
Edwards,64,64,64,63,63,62,316,12.6,0.2%
Van de Ven,87,87,86,80,81,78,412,18.3,17.4%
Pau,73,73,76,73,76,73,371,16.5,0.4%
O'Brien,88,88,87,83,79,79,416,16.6,0.4%
De Ligt,82,82,74,76,72,71,375,15.0,1.0%
Bentancur,77,77,71,71,68,63,350,12.7,0.1%
Wharton,68,68,63,62,62,63,318,12.7,0.5%
André,87,87,83,77,78,81,406,14.8,0.1%
Bogle,86,86,86,81,79,78,410,18.2,0.7%
Havertz,57,57,56,54,50,46,263,7.0,1.4%
Lewis-Potter,78,78,74,71,70,66,359,14.4,0.5%
Burn,76,76,74,68,70,68,356,14.2,3.2%
Trossard,46,46,46,41,42,41,216,6.2,1.5%
Henderson,75,75,72,65,63,58,333,13.3,0.4%
Elanga,55,55,50,50,52,52,259,7.4,9.8%
Rodon,89,89,85,85,82,79,420,21.0,1.8%
N.Jackson,0,0,62,63,60,63,248,7.6,0.1%
Zubimendi,60,60,65,69,73,76,343,12.5,1.7%
Raúl,34,34,43,46,52,50,225,6.9,2.4%
Toti,89,89,88,84,81,83,425,18.9,0.2%
Ward-Prowse,60,60,58,58,63,59,298,9.9,0.4%
Hume,87,87,84,83,80,74,408,18.1,0.3%
Tete,68,68,70,62,56,61,317,14.1,0.2%
Stach,73,73,70,65,64,66,338,13.5,0.1%
Gudmundsson,82,82,78,76,70,71,377,18.9,2.0%
Reinildo,89,89,87,88,81,81,426,21.3,8.3%
Beto,53,53,49,48,50,46,246,8.9,13.9%
Bernardo,57,57,59,58,59,51,284,8.7,0.6%
Livramento,73,73,71,68,67,69,348,13.9,4.3%
James,55,55,55,54,45,52,261,9.5,4.6%
Dalot,71,71,72,71,67,73,354,15.7,2.7%
Mazraoui,70,70,66,63,60,60,319,12.8,1.1%
Bellegarde,53,53,55,54,57,49,268,9.7,0.1%
Odobert,48,48,48,47,49,47,239,8.7,0.1%
Sangaré,63,63,67,64,63,63,320,12.8,0.1%
McGinn,47,47,47,48,51,54,247,9.0,0.6%
Gravenberch,0,0,78,79,77,76,310,11.3,0.1%
Doherty,72,72,73,68,72,72,357,15.9,0.2%
Andreas,43,43,45,47,52,48,235,8.5,0.5%
Gnonto,54,54,54,52,52,54,266,9.7,0.7%
Amad,51,51,52,51,50,53,257,7.9,3.7%
Smith Rowe,45,45,52,51,44,50,242,8.1,1.2%
Barry,48,48,48,47,50,51,244,8.1,1.2%
White,66,66,58,53,51,50,278,10.1,0.9%
Bergvall,51,51,52,57,58,51,269,9.8,0.2%
Weiss,69,69,67,68,67,67,338,15.0,0.2%
Hannibal,65,65,62,62,60,60,309,12.4,0.2%
Roberts,52,52,53,48,48,49,250,9.1,0.1%
Yarmoliuk,63,63,61,59,58,54,295,11.8,0.1%
Walker,85,85,82,81,84,75,407,18.1,2.2%
Kayode,76,76,66,67,58,56,323,14.4,0.3%
Martinelli,43,43,36,37,38,38,192,5.5,1.4%
Berge,71,71,67,66,62,65,331,13.2,0.1%
Barnes,39,39,42,42,40,36,199,6.1,0.5%
Diarra,60,60,60,64,59,59,302,11.0,0.1%
Longstaff,62,62,63,65,63,62,315,12.6,0.3%
Johnson,36,36,42,43,42,42,205,5.9,3.5%
Adams,86,86,82,56,42,40,306,12.2,0.2%
R.Gomes,56,56,57,53,55,52,273,12.1,0.1%
Digne,43,43,51,51,47,48,240,10.7,1.7%
Tuanzebe,78,78,68,70,70,63,349,17.4,3.6%
Hartman,69,69,69,67,62,60,327,16.4,0.4%
Scott,70,70,68,37,35,40,250,10.0,0.1%
Diouf,59,59,53,52,45,42,251,11.2,2.8%
Walker-Peters,61,61,61,69,65,59,315,14.0,0.5%
Tanaka,65,65,63,59,60,56,303,12.1,0.4%
Boscagli,55,55,60,58,58,50,281,12.5,0.2%
Yoro,56,56,61,62,59,55,293,13.0,1.1%
Maatsen,47,47,46,46,46,45,230,10.2,0.9%
Gittens,39,39,33,32,32,38,174,5.4,0.3%
Mainoo,52,52,56,52,58,49,267,10.7,1.0%
Bruun Larsen,49,49,45,44,40,40,218,7.9,0.1%
Mavropanos,41,41,52,56,55,56,260,11.6,0.1%
Højlund,33,33,36,40,45,44,198,6.1,1.1%
Talbi,45,45,45,44,43,40,217,8.7,0.2%
Smith,65,65,65,64,61,60,315,14.0,0.2%
Ampadu,63,63,56,60,60,64,303,12.1,0.1%
Dunk,61,61,61,53,55,59,289,12.8,1.0%
Wilson,34,34,32,36,33,32,167,5.6,0.1%
Ugarte,52,52,50,49,51,53,255,10.2,0.2%
J.Arias,36,36,45,48,43,43,215,7.8,1.1%
Udogie,52,52,54,50,53,49,258,11.5,8.0%
Gündoğan,42,42,36,40,36,36,190,5.8,0.2%
Richarlison,33,33,33,32,33,35,166,5.1,1.0%
O.Dango,33,33,33,35,36,37,174,5.8,0.3%
Bijol,0,0,76,70,67,78,291,14.6,0.2%
Nketiah,32,32,32,34,35,35,168,6.1,1.6%
Merino,36,36,37,37,33,32,175,5.8,0.9%
Matheus N.,40,40,39,35,34,40,188,6.8,0.6%
Doku,33,33,30,35,29,32,159,4.9,1.2%
Hughes,46,46,45,47,47,46,231,9.2,0.1%
Spence,46,46,45,47,52,49,239,10.6,0.6%
C.Jones,46,46,29,33,30,34,172,6.3,0.1%
J.Timber,30,30,36,42,51,58,217,7.9,2.3%
Hinshelwood,46,46,43,45,45,46,225,8.2,0.2%
Darwin,29,29,29,25,27,27,137,4.2,1.4%
Ayari,41,41,42,41,38,37,199,8.0,0.3%
Cook,0,0,0,78,71,76,225,9.0,0.0%
Guedes,26,26,27,31,31,33,148,5.4,0.1%
Hoever,44,44,46,50,45,44,229,11.4,2.5%
F.Kadıoğlu,44,44,46,42,43,41,216,9.6,0.3%
Amdouni,40,40,44,35,32,33,184,7.4,0.4%
Mosquera,42,42,49,47,53,50,241,10.7,0.1%
J.Murphy,30,30,35,32,36,35,168,5.2,2.9%
Sadiki,43,43,47,42,44,43,219,8.8,0.1%
Lerma,40,40,46,38,41,41,206,8.2,0.1%
Maguire,44,44,44,44,46,40,218,9.7,0.6%
Adama,29,29,31,33,36,33,162,5.9,0.4%
Nmecha,30,30,32,30,31,29,152,6.1,0.8%
Yates,39,39,38,37,41,41,196,7.8,0.2%
Jensen,41,41,39,35,31,34,180,7.2,0.1%
Aaronson,27,27,34,39,35,32,167,6.1,0.1%
S.Bueno,47,47,47,53,49,53,249,11.1,0.1%
Patterson,30,30,40,43,43,41,197,8.8,0.2%
Cherki,22,22,24,26,28,25,125,3.8,9.2%
Akanji,39,39,34,43,38,38,192,7.0,0.6%
Isidor,31,31,36,29,28,36,160,5.8,0.4%
Lewis,33,33,38,36,40,40,187,7.5,0.6%
Laurent,39,39,41,39,44,43,206,8.2,0.1%
Sessegnon,22,22,33,32,30,33,150,5.5,0.2%
L.Guilherme,27,27,30,36,26,26,145,5.8,0.1%
Henry,38,38,40,42,42,44,206,9.2,0.2%
Onana,30,30,32,35,36,38,171,6.8,1.7%
Seelt,62,62,58,53,27,10,210,10.5,0.4%
Jota,22,22,22,28,27,29,128,4.7,0.1%
Kamada,29,29,29,29,30,30,147,5.9,0.1%
Foster,27,27,31,26,32,26,142,5.7,0.4%
G.Rodriguez,36,36,34,35,35,35,175,7.0,0.1%
Ramazani,21,21,23,25,28,24,121,4.8,0.1%
Milambo,16,16,24,26,31,36,133,4.8,0.1%
Mount,24,24,26,28,23,24,125,4.2,0.2%
Casemiro,29,29,24,30,32,30,145,5.3,0.2%
Savinho,18,18,17,22,20,23,100,2.9,1.9%
Gruda,18,18,27,25,21,23,114,4.1,0.1%
Mings,27,27,30,33,29,37,156,6.9,0.5%
O'Riley,21,21,23,22,22,24,112,4.1,0.2%
Harrison,22,22,23,25,29,23,122,4.4,0.2%
Trippier,28,28,23,30,32,28,141,5.6,1.5%
Gusto,25,25,29,27,27,32,140,5.6,2.2%
Robertson,22,22,25,23,23,25,118,3.9,2.1%
P.M.Sarr,22,22,25,29,27,30,133,5.3,1.8%
Christie,0,0,0,22,57,56,135,5.4,0.5%
Lavia,32,32,30,27,33,30,152,6.1,0.1%
Bradley,19,19,18,25,24,25,111,4.4,0.7%
Bailey,15,15,18,19,19,18,89,3.2,0.5%
Morato,22,22,27,30,32,35,146,6.5,0.1%
Álvarez,21,21,26,32,29,31,139,5.6,0.2%
Botman,23,23,26,27,27,34,137,5.5,0.5%
J.Araujo,31,31,30,31,28,34,154,7.7,1.3%
Struijk,63,63,17,21,23,20,144,6.4,0.4%
Delap,26,26,13,11,13,15,78,2.4,4.6%
Castagne,24,24,29,30,31,28,142,6.3,0.2%
Coppola,22,22,28,28,29,28,135,6.0,0.1%
Wieffer,21,21,25,24,25,27,122,4.9,0.1%
Brooks,20,20,24,19,16,18,97,3.9,0.2%
Aké,22,22,23,25,26,31,127,4.6,0.5%
Shaw,26,26,25,30,33,26,140,6.2,0.2%
Zirkzee,11,11,14,18,17,24,84,2.8,1.1%
Iroegbunam,19,19,25,25,25,25,119,4.8,0.1%
Calafiori,23,23,20,21,20,19,103,3.7,0.6%
Elliott,20,20,11,14,16,15,76,2.8,0.2%
Madueke,7,7,10,14,18,20,69,2.0,1.7%
Gomez,13,13,18,20,27,29,107,4.3,0.2%
A.Ramsey,10,10,11,18,23,34,96,4.3,12.8%
Igor Jesus,12,12,16,17,15,18,78,2.6,1.3%
Sinisterra,14,14,16,18,14,18,80,3.2,0.2%
Hladký,25,25,29,25,28,28,135,6.8,0.5%
Rigg,14,14,18,20,19,20,91,3.6,0.1%
L.Miley,17,17,22,25,20,16,100,4.4,3.3%
Danso,15,15,24,21,24,30,114,5.1,0.1%
M.França,9,9,11,18,18,17,73,3.2,0.1%
Bornauw,42,42,17,20,23,23,125,6.3,0.3%
Awoniyi,13,13,13,14,16,18,74,2.7,0.8%
Gomez,13,13,13,17,20,21,84,3.4,0.1%
Ekdal,20,20,22,22,24,24,112,5.6,0.3%
Chalobah,15,15,15,22,22,19,93,3.7,0.6%
Estêvão,15,15,10,12,12,13,62,1.9,0.5%
Lamptey,19,19,14,16,20,22,91,4.0,0.4%
Philip,23,23,28,9,5,7,72,2.9,0.1%
Veltman,20,20,22,29,20,17,108,4.8,0.3%
M.Bizot,93,93,3,2,2,4,104,4.6,0.3%
Scarles,13,13,19,20,18,20,90,4.0,0.1%
Osula,7,7,9,11,16,12,55,2.0,0.2%
Ekwah,20,20,21,24,17,12,94,4.2,0.1%
Esse,8,8,12,14,13,14,61,2.4,0.3%
Hee Chan,5,5,10,11,14,15,55,1.8,0.2%
Khusanov,18,18,16,16,20,21,91,3.3,0.3%
Koleosho,14,14,13,13,14,16,70,2.8,0.1%
N.Gonzalez,12,12,14,17,15,17,75,2.5,0.1%
Cairney,9,9,11,12,15,21,68,2.7,0.1%
Kroupi.Jr,11,11,16,9,9,11,56,2.5,1.5%
Sosa,11,11,13,14,15,18,71,2.8,0.1%
Clyne,11,11,15,19,20,19,84,4.2,0.7%
Barkley,8,8,9,13,11,16,57,2.3,0.3%
Nunes,9,9,9,14,9,12,53,2.1,0.1%
King,8,8,13,12,12,19,64,2.8,0.3%
Tchaouna,8,8,12,12,11,13,56,2.2,0.1%
O'Nien,0,0,0,0,36,78,114,5.7,0.0%
Summerville,0,0,0,0,21,45,66,2.4,0.0%
Stones,11,11,16,17,12,19,75,2.7,0.5%
Aznou,10,10,16,17,20,22,85,3.8,0.1%
Chiesa,7,7,7,7,8,9,38,1.2,0.1%
Hato,10,10,13,14,18,19,74,3.0,0.1%
Byram,15,15,13,17,16,23,84,4.2,0.4%
Dewsbury-Hall,7,7,9,16,11,12,55,2.2,0.4%
Hickey,5,5,11,17,21,32,86,4.3,0.8%
Nørgaard,12,12,11,13,12,15,63,2.3,0.7%
Benson,10,10,8,10,11,12,51,1.9,0.0%
Pinnock,6,6,10,20,18,17,71,3.2,0.3%
Neil,10,10,16,18,16,18,78,3.1,0.1%
Humphreys,11,11,16,18,16,19,80,4.0,0.4%
Pedro Lima,11,11,12,15,16,17,71,3.5,1.4%
Kiwior,11,11,10,14,15,17,67,2.4,0.1%
Grealish,6,6,7,8,8,9,38,1.2,0.1%
Nwaneri,6,6,7,10,6,9,38,1.4,0.4%
Lesley Ugochukwu,11,11,8,11,15,13,58,0.1,0.0%
Nkunku,7,7,5,6,7,7,32,1.1,0.3%
Bissouma,10,10,9,14,12,13,58,2.1,0.1%
Mepham,9,9,14,14,16,18,71,3.5,0.3%
Gruev,8,8,10,11,15,19,63,2.5,0.1%
Endo,23,23,4,6,6,7,46,1.8,0.1%
Janelt,0,0,0,11,26,22,59,2.4,0.2%
Devenny,5,5,8,8,10,10,41,1.8,1.7%
March,0,0,0,5,17,19,41,1.4,0.1%
Lucas Pires,9,9,12,17,18,17,73,3.6,0.3%
Tzimas,4,4,7,5,5,7,28,1.0,0.1%
Barnes,6,6,4,9,7,10,36,1.6,5.0%
Gray,8,8,11,12,13,18,62,2.5,0.2%
Igor,9,9,13,15,17,15,69,3.1,0.1%
Mundle,0,0,0,8,17,19,44,1.8,0.1%
Diop,7,7,13,16,15,16,67,3.0,0.1%
A.García,8,8,8,10,10,13,49,2.5,1.0%
Buonanotte,4,4,7,8,7,5,31,1.2,0.3%
Willock,0,0,0,0,13,30,43,1.7,0.2%
H.Bueno,10,10,9,13,11,7,50,2.2,0.1%
Ajer,7,7,12,15,12,11,57,2.5,0.2%
Y.Chermiti,4,4,5,6,7,7,29,1.2,0.2%
Doucouré,4,2,7,14,10,10,43,1.7,0.0%
Bayindir,49,49,5,2,1,2,59,2.4,0.5%
Josh Bowler,4,4,7,6,5,8,30,0.1,0.0%
Da Silva Moreira,3,3,6,8,5,8,30,1.3,0.2%
Bobb,2,2,5,6,5,8,26,0.9,0.1%
Poveda,5,5,7,6,5,6,29,1.2,0.1%
Emerson,5,5,8,9,10,6,38,1.7,0.2%
Huggins,12,12,15,16,7,3,53,2.6,0.3%
Stamenic,4,4,5,7,11,12,39,1.7,0.1%
McAtee,2,2,2,4,7,8,23,0.8,0.1%
Keane,6,6,5,10,12,16,49,2.2,0.3%
Tsimikas,4,4,4,6,6,9,29,1.2,0.1%
Pembele,8,8,7,13,11,8,47,2.4,0.3%
O.Richards,3,3,8,9,10,13,43,1.9,0.1%
Bryan,1,1,5,5,6,4,21,0.8,0.1%
Heaven,5,5,5,10,10,10,40,2.0,2.1%
Roberts,8,8,10,9,7,12,46,2.0,0.1%
Sima,2,2,4,3,3,5,17,0.6,0.0%
Coleman,3,3,8,7,10,10,38,1.7,0.1%
Tosin,5,5,4,9,10,13,41,1.8,0.3%
Patterson,4,4,7,9,13,13,46,2.0,0.5%
David Møller Wolfe,9,9,8,9,8,9,43,0.1,0.0%
Obi,2,2,4,4,5,3,18,0.8,4.9%
Cornet,2,2,3,5,3,4,17,0.7,0.1%
Hill,3,3,7,7,10,10,37,1.9,0.7%
Mamardashvili,1,1,5,7,9,10,32,1.4,0.7%
Roerslev,7,7,8,8,7,5,35,1.6,0.1%
Obafemi,3,3,3,4,2,4,16,0.7,0.8%
Benitez,4,4,5,7,8,11,35,1.8,0.5%
Solomon,1,1,1,2,5,7,16,0.6,0.1%
Armstrong,3,3,4,6,9,10,32,1.4,0.4%
Bamford,2,2,3,3,4,2,14,0.6,3.1%
Alex Moreno,3,3,4,6,8,7,28,1.4,11.6%
Hayden,1,1,2,7,5,3,18,0.8,0.1%
Soler,3,3,7,6,8,7,31,1.6,0.4%
George,3,3,3,3,1,1,11,0.4,0.1%
Raheem Sterling,3,3,1,3,2,3,12,0.0,0.0%
Krafth,2,2,3,9,7,10,31,1.4,0.1%
Carney Chukwuemeka,2,2,2,2,2,4,12,0.0,0.0%
Kalajdžić,1,1,1,4,2,4,12,0.5,0.2%
Malacia,3,3,4,6,5,5,23,1.1,0.4%
Kovačić,0,0,0,0,9,16,25,0.8,0.0%
Davies,2,2,4,7,9,5,27,1.2,0.1%
Irving,1,1,2,4,3,2,12,0.5,0.3%
Martinez,0,0,0,0,3,25,28,1.1,0.6%
Zinchenko,1,1,2,5,5,3,16,0.6,0.3%
Fer López,0,0,2,2,4,3,11,0.4,0.1%
Faivre,1,1,2,1,3,2,9,0.4,0.3%
Amass,3,3,5,4,7,5,24,1.2,0.3%
Greenwood,0,0,2,2,2,4,10,0.4,0.1%
Neto,2,2,5,6,4,7,24,1.1,1.2%
Bogarde,1,1,3,6,7,6,23,1.1,0.3%
Browne,1,1,3,2,3,5,14,0.6,0.1%
Fábio Silva,0,0,1,2,3,3,9,0.4,0.7%
Marshall,1,1,0,2,2,3,8,0.4,0.9%
Triantis,4,4,3,4,4,1,16,0.7,0.1%
Hjelde,0,0,0,0,11,16,27,1.4,0.0%
Jordan,1,1,2,6,9,12,30,1.5,0.2%
Reed,0,0,2,3,3,3,11,0.5,0.3%
Collyer,1,1,2,3,4,3,13,0.6,0.2%
Sarmiento,0,0,1,2,2,3,8,0.3,0.1%
Alese,0,0,0,0,16,9,25,1.3,0.0%
Schmidt,3,3,1,5,5,5,19,0.9,0.3%
O’Reilly,1,1,1,1,1,2,6,0.2,0.2%
Arrizabalaga,1,1,2,4,3,5,15,0.7,1.0%
M.Sarr,3,3,4,6,5,4,22,1.0,0.1%
Holding,1,1,2,7,4,5,19,0.9,0.3%
Gelhardt,0,0,1,2,1,2,6,0.3,0.3%
Jörgensen,2,2,1,3,3,7,16,0.7,0.2%
Buendía,0,0,1,1,1,2,5,0.2,0.1%
Rusyn,0,0,1,1,2,2,6,0.3,0.3%
J.Cuenca,0,0,2,4,4,6,16,0.7,0.1%
Jair Cunha,1,1,3,2,6,6,18,0.8,0.1%
Travers,0,0,3,3,4,5,15,0.7,0.2%
Ortega Moreno,0,0,4,3,3,3,13,0.5,0.5%
Maghoma,1,1,2,1,2,2,8,0.4,0.1%
Steele,1,1,2,4,4,3,14,0.6,0.4%
Trafford,0,0,2,4,3,3,12,0.5,3.4%
B.Badiashile,1,1,3,2,5,3,14,0.6,0.1%
D.Essugo,0,0,1,1,1,1,4,0.2,0.1%
Valdimarsson,1,1,1,4,4,2,12,0.6,2.1%
Darlow,1,1,1,4,4,2,12,0.6,7.5%
Mosquera,1,1,2,2,2,5,12,0.4,0.1%
Axel Disasi,0,0,2,3,2,7,14,0.0,0.0%
H.Traorè,0,0,1,1,1,1,4,0.2,0.3%
Bajcetic,0,0,0,0,2,3,5,0.2,0.1%
Lecomte,1,1,1,1,3,4,10,0.5,1.0%
Armando Broja,2,2,1,0,0,1,4,0.0,0.0%
Winterburn,2,2,3,0,0,0,5,0.2,0.1%
David Datro Fofana,1,1,0,0,1,1,3,0.0,0.0%
Kinsky,1,1,0,2,1,4,8,0.4,5.4%
Fábio Vieira,0,0,1,0,1,1,3,0.1,0.1%
Foderingham,0,0,2,3,2,1,8,0.4,1.0%
Nelson,0,0,0,0,2,1,3,0.1,0.2%
C.Miguel,0,0,2,3,2,1,8,0.4,0.3%
N.Aguerd,0,0,1,4,3,3,11,0.5,0.1%
Godo,0,0,0,0,1,1,2,0.1,0.1%
Johnstone,0,0,0,3,2,2,7,0.3,0.2%
Ji-soo,0,0,0,2,2,3,7,0.3,0.2%
Delcroix,0,0,1,2,4,2,9,0.5,0.5%
Édouard,0,0,0,0,1,1,2,0.1,1.1%
Sambi,0,0,0,1,0,1,2,0.1,0.2%
Kuol,0,0,0,1,1,0,2,0.1,0.1%
Redmond,0,0,0,0,1,1,2,0.1,0.9%
R.Williams,0,0,1,2,1,1,5,0.3,0.3%
Abbott,1,1,0,2,1,0,4,0.2,0.3%
Renato Veiga,0,0,0,1,1,2,4,0.0,0.0%
Konak,0,0,1,1,0,0,2,0.1,0.2%
Sonne,0,0,1,0,0,1,2,0.1,0.2%
Anderson,0,0,1,2,1,0,4,0.2,0.6%
Edozie,0,0,0,0,0,1,1,0.0,0.4%
Pond,0,0,0,0,1,2,3,0.1,2.2%
Targett,0,0,0,0,1,1,2,0.1,0.5%
Boly,0,0,0,1,0,1,2,0.1,0.6%
Scarlett,0,0,0,0,1,0,1,0.0,0.9%
Potts,0,0,0,0,1,1,2,0.1,0.7%
Casey,0,0,0,1,1,1,3,0.1,0.8%
Watson,0,0,0,1,0,0,1,0.0,0.1%
Ben Chilwell,0,0,0,0,1,0,1,0.0,0.0%
Aleksić,0,0,1,0,0,0,1,0.0,0.1%
Kone,0,0,0,0,1,0,1,0.0,0.1%
Gauci,1,1,0,0,0,0,1,0.1,1.1%
Akinmboni,0,0,0,1,1,0,2,0.1,0.4%
Cox,0,0,0,0,0,1,1,0.1,0.2%
Iling Jr,0,0,0,0,0,1,1,0.0,0.0%
Bentley,0,0,0,0,0,1,1,0.1,1.3%
Andrey Santos,0,0,0,0,1,0,1,0.0,0.4%
A.Murphy,0,0,0,0,0,1,1,0.1,0.8%
Welch,0,0,0,0,0,1,1,0.1,0.2%
Meslier,0,0,0,0,0,1,1,0.0,1.1%
Lascelles,0,0,0,0,0,1,1,0.0,0.1%
Hein,0,0,0,0,0,0,0,0.0,0.6%
Setford,0,0,0,0,0,0,0,0.0,0.2%
Clarke,0,0,0,0,0,0,0,0.0,0.6%
Kacurri,0,0,0,0,0,0,0,0.0,0.3%
Nichols,0,0,0,0,0,0,0,0.0,0.2%
Kabia,0,0,0,0,0,0,0,0.0,0.3%
G.Jesus,0,0,0,0,0,0,0,0.0,0.0%
Marschall,0,0,0,0,0,0,0,0.0,0.1%
Sousa,0,0,0,0,0,0,0,0.0,0.3%
Yasin,0,0,0,0,0,0,0,0.0,0.3%
Barrenechea,0,0,0,0,0,0,0,0.0,0.0%
Dobbin,0,0,0,0,0,0,0,0.0,0.1%
Broggio,0,0,0,0,0,0,0,0.0,0.3%
Dendoncker,0,0,0,0,0,0,0,0.0,0.4%
Jimoh-Aloba,0,0,0,0,0,0,0,0.0,0.1%
Young,0,0,0,0,0,0,0,0.0,0.6%
Dennis,0,0,0,0,0,0,0,0.0,0.7%
McKenna,0,0,0,0,0,0,0,0.0,0.2%
Paulsen,0,0,0,0,0,0,0,0.0,0.2%
Bevan,0,0,0,0,0,0,0,0.0,0.3%
Sadi,0,0,0,0,0,0,0,0.0,0.1%
Silcott-Duberry,0,0,0,0,0,0,0,0.0,0.3%
Enes Ünal,0,0,0,0,0,0,0,0.0,0.0%
Adu-Adjei,0,0,0,0,0,0,0,0.0,0.4%
Balcombe,0,0,0,0,0,0,0,0.0,0.3%
Eyestone,0,0,0,0,0,0,0,0.0,0.1%
Arthur,0,0,0,0,0,0,0,0.0,0.4%
Fredrick,0,0,0,0,0,0,0,0.0,0.2%
Meghoma,0,0,0,0,0,0,0,0.0,0.2%
Onyeka,0,0,0,0,0,0,0,0.0,0.1%
Donovan,0,0,0,0,0,0,0,0.0,0.1%
Peart-Harris,0,0,0,0,0,0,0,0.0,0.1%
Trevitt,0,0,0,0,0,0,0,0.0,0.1%
Morgan,0,0,0,0,0,0,0,0.0,0.6%
McGill,0,0,0,0,0,0,0,0.0,0.3%
Rushworth,0,0,0,0,0,0,0,0.0,0.0%
Scherpen,0,0,0,0,0,0,0,0.0,0.0%
Estupiñan,0,0,0,0,0,0,0,0.0,0.3%
Webster,0,0,0,0,0,0,0,0.0,0.1%
Cashin,0,0,0,0,0,0,0,0.0,0.1%
Slater,0,0,0,0,0,0,0,0.0,0.2%
Tasker,0,0,0,0,0,0,0,0.0,0.2%
Enciso,0,0,0,0,0,0,0,0.0,0.2%
Milner,0,0,0,0,0,0,0,0.0,0.1%
Yalcouye,0,0,0,0,0,0,0,0.0,0.1%
Knight,0,0,0,0,0,0,0,0.0,0.1%
Mazilu,0,0,0,0,0,0,0,0.0,0.1%
Moran,0,0,0,0,0,0,0,0.0,0.1%
Ferguson,0,0,0,0,0,0,0,0.0,0.1%
Kostoulas,0,0,0,0,0,0,0,0.0,0.7%
Green,0,0,0,0,0,0,0,0.0,0.5%
Dodgson,0,0,0,0,0,0,0,0.0,0.3%
Sambo,0,0,0,0,0,0,0,0.0,0.2%
Worrall,0,0,0,0,0,0,0,0.0,0.2%
Boateng,0,0,0,0,0,0,0,0.0,0.1%
Churlinov,0,0,0,0,0,0,0,0.0,0.1%
Adewumi,0,0,0,0,0,0,0,0.0,0.1%
Banel,0,0,0,0,0,0,0,0.0,0.0%
Trésor,0,0,0,0,0,0,0,0.0,0.1%
Penders,0,0,0,0,0,0,0,0.0,0.1%
Slonina,0,0,0,0,0,0,0,0.0,0.1%
Acheampong,0,0,0,0,0,0,0,0.0,0.3%
Anselmino,0,0,0,0,0,0,0,0.0,0.2%
Mudryk,0,0,0,0,0,0,0,0.0,0.0%
Paez,0,0,0,0,0,0,0,0.0,0.1%
Marc Guiu,0,0,0,0,0,0,0,0.0,5.2%
Matthews,0,0,0,0,0,0,0,0.0,0.1%
Chadi Riad,0,0,0,0,0,0,0,0.0,0.0%
Kporha,0,0,0,0,0,0,0,0.0,0.2%
Agbinone,0,0,0,0,0,0,0,0.0,0.1%
Ahamada,0,0,0,0,0,0,0,0.0,0.1%
Ebiowei,0,0,0,0,0,0,0,0.0,0.1%
J.Rak-Sakyi,0,0,0,0,0,0,0,0.0,0.1%
Ozoh,0,0,0,0,0,0,0,0.0,0.0%
Rodney,0,0,0,0,0,0,0,0.0,0.0%
Umeh,0,0,0,0,0,0,0,0.0,0.0%
Marsh,0,0,0,0,0,0,0,0.0,0.3%
Tyrer,0,0,0,0,0,0,0,0.0,0.2%
Dixon,0,0,0,0,0,0,0,0.0,0.3%
Bates,0,0,0,0,0,0,0,0.0,0.1%
Ebere,0,0,0,0,0,0,0,0.0,0.0%
Heath,0,0,0,0,0,0,0,0.0,0.0%
Metcalfe,0,0,0,0,0,0,0,0.0,0.0%
Sherif,0,0,0,0,0,0,0,0.0,0.3%
Benda,0,0,0,0,0,0,0,0.0,0.1%
Amissah,0,0,0,0,0,0,0,0.0,0.2%
Harris,0,0,0,0,0,0,0,0.0,0.0%
Cairns,0,0,0,0,0,0,0,0.0,0.3%
Crew,0,0,0,0,0,0,0,0.0,0.1%
Gyabi,0,0,0,0,0,0,0,0.0,0.1%
Mateo Joseph,0,0,0,0,0,0,0,0.0,0.2%
Pécsi,0,0,0,0,0,0,0,0.0,0.1%
Woodman,0,0,0,0,0,0,0,0.0,0.1%
Nallo,0,0,0,0,0,0,0,0.0,0.2%
Ramsay,0,0,0,0,0,0,0,0.0,0.2%
Luis Díaz,0,0,0,0,0,0,0,0.0,1.0%
Doak,0,0,0,0,0,0,0,0.0,0.1%
McConnell,0,0,0,0,0,0,0,0.0,0.0%
Morton,0,0,0,0,0,0,0,0.0,0.0%
Nyoni,0,0,0,0,0,0,0,0.0,0.1%
Danns,0,0,0,0,0,0,0,0.0,0.2%
Bettinelli,0,0,0,0,0,0,0,0.0,0.2%
Vitor Reis,0,0,0,0,0,0,0,0.0,0.1%
Echeverri,0,0,0,0,0,0,0,0.0,0.1%
Nypan,0,0,0,0,0,0,0,0.0,0.1%
Phillips,0,0,0,0,0,0,0,0.0,0.1%
Harrison,0,0,0,0,0,0,0,0.0,0.0%
Heaton,0,0,0,0,0,0,0,0.0,0.4%
Mee,0,0,0,0,0,0,0,0.0,0.2%
D.Leon,0,0,0,0,0,0,0,0.0,0.1%
Fredricson,0,0,0,0,0,0,0,0.0,0.2%
Rashford,0,0,0,0,0,0,0,0.0,0.4%
Garnacho,0,0,0,0,0,0,0,0.0,0.2%
Antony,0,0,0,0,0,0,0,0.0,0.1%
Sancho,0,0,0,0,0,0,0,0.0,0.1%
Fitzgerald,0,0,0,0,0,0,0,0.0,0.0%
J.Fletcher,0,0,0,0,0,0,0,0.0,0.0%
Moorhouse,0,0,0,0,0,0,0,0.0,0.0%
Wheatley,0,0,0,0,0,0,0,0.0,0.2%
Dúbravka,0,0,0,0,0,0,0,0.0,13.3%
Gillespie,0,0,0,0,0,0,0,0.0,0.1%
Odysseas,0,0,0,0,0,0,0,0.0,0.1%
Ashby,0,0,0,0,0,0,0,0.0,0.2%
Pivas,0,0,0,0,0,0,0,0.0,0.2%
Antoñito C.,0,0,0,0,0,0,0,0.0,0.1%
White,0,0,0,0,0,0,0,0.0,0.1%
Neave,0,0,0,0,0,0,0,0.0,0.3%
Turner,0,0,0,0,0,0,0,0.0,1.4%
David Carmo,0,0,0,0,0,0,0,0.0,0.1%
Dominguez,0,0,0,0,0,0,0,0.0,0.0%
O'Brien,0,0,0,0,0,0,0,0.0,0.0%
Moore,0,0,0,0,0,0,0,0.0,0.6%
Nna Noukeu,0,0,0,0,0,0,0,0.0,0.3%
Cirkin,0,0,0,0,0,0,0,0.0,0.2%
Johnson,0,0,0,0,0,0,0,0.0,0.3%
Ba,0,0,0,0,0,0,0,0.0,0.4%
H.Jones,0,0,0,0,0,0,0,0.0,0.1%
Matete,0,0,0,0,0,0,0,0.0,0.3%
Abdullahi,0,0,0,0,0,0,0,0.0,1.1%
Luís Hemir,0,0,0,0,0,0,0,0.0,0.3%
Austin,0,0,0,0,0,0,0,0.0,0.3%
Dragusin,0,0,0,0,0,0,0,0.0,0.0%
Phillips,0,0,0,0,0,0,0,0.0,0.2%
Takai,0,0,0,0,0,0,0,0.0,0.4%
Vuskovic,0,0,0,0,0,0,0,0.0,2.3%
Son,0,0,0,0,0,0,0,0.0,2.2%
Maddison,0,0,0,0,0,0,0,0.0,2.8%
Kulusevski,0,0,0,0,0,0,0,0.0,0.0%
Moore,0,0,0,0,0,0,0,0.0,0.1%
Min-hyeok,0,0,0,0,0,0,0,0.0,0.2%
Olusesi,0,0,0,0,0,0,0,0.0,0.2%
Lankshear,0,0,0,0,0,0,0,0.0,0.4%
Hegyi,0,0,0,0,0,0,0,0.0,0.4%
Earthy,0,0,0,0,0,0,0,0.0,0.2%
Orford,0,0,0,0,0,0,0,0.0,0.2%
King,0,0,0,0,0,0,0,0.0,2.9%
Meupiyou,0,0,0,0,0,0,0,0.0,0.1%
B.Traore,0,0,0,0,0,0,0,0.0,0.0%
Chirewa,0,0,0,0,0,0,0,0.0,0.3%
Gonzalez,0,0,0,0,0,0,0,0.0,1.3%
Hodge,0,0,0,0,0,0,0,0.0,0.4%
Chiwome,0,0,0,0,0,0,0,0.0,0.1%
Fraser,0,0,0,0,0,0,0,0.0,2.7%
J.Palhinha,0,0,0,0,0,0,0,0.0,0.1%
Ramsdale,0,0,0,0,0,0,0,0.0,0.1%
Josh Wilson-Esbrand,0,0,0,0,0,0,0,0.0,0.0%
Issa Kaboré,0,0,0,0,0,0,0,0.0,0.0%
Alfie Gilchrist,0,0,0,0,0,0,0,0.0,0.0%
Alfie Devine,0,0,0,0,0,0,0,0.0,0.0%
Emmanuel Dennis,0,0,0,0,0,0,0,0.0,0.0%
Max Dowman,0,0,0,0,0,0,0,0.0,0.0%
Hindolo Mustapha,0,0,0,0,0,0,0,0.0,0.0%
Omari Kellyman,0,0,0,0,0,0,0,0.0,0.0%
