Name,xMins,GW1,GW2,GW3,GW4,GW5,Total,xMins/£M,Elite%
M.Salah,88,88,86,83,77,82,416,5.7,57.5%
Palmer,87,87,87,84,88,80,426,8.1,53.7%
Haaland,89,89,81,80,81,76,407,5.8,20.2%
Watkins,86,86,84,84,83,85,422,9.4,16.4%
Marmoush,75,75,69,68,68,75,355,8.4,13.7%
Saka,84,84,80,80,76,75,395,7.9,15.2%
Isak,88,88,83,80,82,75,408,7.8,27.0%
B.Fernandes,91,91,83,84,84,87,429,9.5,14.2%
Wirtz,84,84,82,79,75,77,397,9.3,32.8%
Eze,84,84,84,78,79,75,400,10.7,9.2%
Mateta,85,85,82,82,80,72,401,10.7,6.3%
Rogers,87,87,87,81,80,79,414,11.8,23.8%
Solanke,84,84,79,76,74,78,391,10.4,11.8%
Bowen,90,90,87,88,81,77,423,10.6,20.2%
Virgil,91,91,87,82,83,85,428,14.3,23.8%
Gibbs-White,89,89,84,83,81,81,418,11.1,4.8%
Sarr,83,83,81,79,77,75,395,12.2,2.3%
Gakpo,67,67,63,64,64,60,318,8.5,4.9%
Semenyo,86,86,80,84,82,80,412,11.8,5.1%
Neto,84,84,83,76,74,72,389,11.1,4.2%
Ødegaard,86,86,82,79,78,73,398,9.9,3.3%
Wood,80,80,78,76,74,71,379,10.1,16.4%
Frimpong,81,81,77,73,71,70,372,12.4,25.7%
Mac Allister,87,87,78,77,73,73,388,11.9,1.5%
Evanilson,84,84,82,77,77,74,394,11.3,2.5%
Enzo,89,89,88,88,86,81,432,13.3,4.1%
Tielemans,85,85,83,79,75,76,398,13.3,1.7%
Ndiaye,78,78,76,74,75,72,375,11.5,12.7%
Strand Larsen,83,83,79,77,78,75,392,12.1,5.9%
Mitoma,84,84,79,78,74,77,392,12.1,6.0%
Mbeumo,82,82,76,71,72,70,371,9.3,16.8%
Rice,80,80,79,80,75,78,392,12.1,7.5%
Joelinton,90,90,83,85,79,80,417,13.9,0.5%
L.Paquetá,80,80,75,76,71,71,373,12.4,1.0%
Damsgaard,85,85,79,80,80,77,401,13.4,1.2%
Schade,71,71,73,68,69,72,353,10.1,1.9%
Welbeck,76,76,71,64,64,63,338,10.4,7.7%
A.Becker,94,94,91,85,88,84,442,16.1,11.0%
Cunha,76,76,72,70,73,65,356,8.9,10.4%
Anderson,85,85,84,79,83,81,412,15.0,4.4%
Iwobi,82,82,82,80,78,76,398,12.2,1.5%
Muñoz,90,90,89,82,82,80,423,15.4,8.5%
Murillo,88,88,88,82,77,80,415,15.1,4.8%
Rodrigo,86,86,83,80,84,78,411,12.6,1.6%
Raya,93,93,91,91,91,89,455,16.5,18.0%
Konaté,83,83,81,80,77,76,397,14.4,2.8%
Cucurella,91,91,85,84,83,85,428,14.3,18.9%
Pedro Porro,82,82,79,77,77,81,396,14.4,11.3%
Malen,64,64,64,59,57,59,303,11.0,3.0%
Sánchez,94,94,92,88,88,88,450,18.0,15.6%
Lacroix,91,91,90,85,82,81,429,17.2,1.0%
Ederson M.,92,92,90,87,89,88,446,16.2,3.7%
Bruno G.,90,90,88,86,81,81,426,13.1,1.5%
Kudus,74,74,67,71,64,67,343,10.6,25.3%
N.Williams,90,90,83,80,84,79,416,16.6,4.4%
Kluivert,74,74,68,65,61,57,325,9.3,4.8%
Georginio,63,63,60,59,57,60,299,10.0,0.4%
Tarkowski,92,92,89,85,82,86,434,15.8,5.0%
Milenković,90,90,90,86,87,86,439,16.0,9.1%
Caicedo,91,91,85,87,83,82,428,15.6,7.1%
Richards,86,86,86,79,84,79,414,18.4,1.0%
Gabriel,71,71,80,83,79,80,393,13.1,22.0%
Saliba,90,90,88,86,85,82,431,14.4,14.0%
Guéhi,91,91,89,87,87,87,441,19.6,13.2%
Collins,92,92,89,88,85,80,434,17.4,1.7%
Tonali,91,91,84,82,80,79,416,15.1,2.3%
Schär,87,87,84,85,81,78,415,15.1,2.3%
Areola,94,94,93,91,91,91,460,20.4,5.5%
Wilson,70,70,67,64,58,58,317,11.5,1.4%
Sels,94,94,93,91,91,88,457,18.3,17.9%
Flemming,74,74,75,71,68,68,356,12.9,0.2%
Andersen,89,89,89,87,85,86,436,19.4,1.4%
Pickford,94,94,93,92,92,90,461,16.8,12.2%
Verbruggen,93,93,93,92,92,93,463,20.6,6.8%
Van den Berg,92,92,85,86,85,82,430,19.1,0.4%
Vicario,93,93,91,92,91,90,457,18.3,3.4%
Gyökeres,48,48,45,52,48,52,245,5.4,23.3%
Gomes,88,88,85,84,81,79,417,15.2,0.1%
Kelleher,94,94,92,90,90,89,455,20.2,31.4%
Wissa,57,57,58,57,55,55,282,7.5,7.0%
Munetsi,84,84,78,75,76,72,385,14.0,0.1%
Gordon,64,64,64,64,62,62,316,8.4,3.1%
Wan-Bissaka,90,90,90,82,83,84,429,19.1,31.3%
McNeil,78,78,80,73,72,68,371,12.4,0.8%
Leno,92,92,92,90,91,89,454,18.2,1.7%
Gana,89,89,85,83,80,81,418,15.2,0.1%
Minteh,64,64,64,62,66,56,312,10.4,1.3%
Petrović,93,93,89,90,90,88,450,20.0,4.2%
Konsa,90,90,89,88,84,84,435,19.3,23.5%
Kilman,90,90,88,84,84,81,427,19.0,0.4%
Estève,91,91,89,85,86,87,438,21.9,12.8%
Henderson,89,89,90,88,86,83,436,17.4,3.5%
José Sá,93,93,93,92,93,91,462,20.5,2.4%
Hall,87,87,83,76,79,78,403,14.7,2.7%
Reijnders,66,66,66,65,66,66,329,12.0,4.6%
Perri,93,93,94,89,90,90,456,20.3,0.3%
J.Arias,55,55,58,63,63,63,302,11.0,1.2%
Todibo,88,88,84,82,82,85,421,18.7,0.1%
Senesi,86,86,85,80,81,79,411,18.3,0.7%
Gvardiol,69,69,72,67,67,65,340,11.3,17.4%
Tel,54,54,54,53,55,53,269,8.3,0.2%
Baleba,87,87,83,83,83,76,412,16.5,4.8%
Füllkrug,69,69,64,59,62,58,312,10.4,2.1%
Dorgu,80,80,76,76,77,76,385,17.1,5.5%
Romero,90,90,85,83,81,82,421,16.8,1.8%
Anthony,70,70,72,69,69,69,349,12.7,0.1%
Hudson-Odoi,74,74,73,69,67,66,349,11.6,1.8%
Zabarnyi,91,91,86,85,87,84,433,17.3,0.5%
Ekitiké,47,47,46,42,46,47,228,5.4,5.4%
Cash,79,79,75,73,71,74,372,16.5,1.7%
Van Hecke,92,92,87,85,83,81,428,19.0,1.2%
Pope,87,87,86,86,83,80,422,16.9,3.8%
Dúbravka,90,90,90,89,87,88,444,22.2,18.7%
Szoboszlai,67,67,49,50,47,48,261,8.0,1.8%
Adingra,76,76,78,73,73,70,370,13.5,2.7%
Alcaraz,67,67,69,71,69,69,345,12.5,0.3%
Mitchell,76,76,77,76,73,76,378,15.1,1.0%
Thiago,51,51,50,50,51,54,256,8.5,1.1%
Lewis-Skelly,82,82,77,72,73,69,373,13.6,5.4%
Branthwaite,91,91,85,84,81,83,424,15.4,1.9%
Tavernier,65,65,56,56,59,57,293,10.7,0.4%
João Pedro,66,66,52,48,45,49,260,6.9,51.9%
James,69,69,64,63,63,60,319,11.6,0.8%
Piroe,69,69,62,64,61,59,315,11.5,3.3%
Souček,73,73,71,69,69,67,349,11.6,0.9%
Truffert,90,90,85,82,83,84,424,18.8,1.3%
Onana,92,46,87,91,90,93,407,16.3,0.1%
Aït-Nouri,58,58,61,64,58,59,300,10.0,23.3%
Rúben,79,79,77,73,71,71,371,13.5,2.5%
Roefs,86,86,89,88,86,86,435,19.3,0.1%
Agbadou,91,91,85,85,82,81,424,18.8,0.3%
Aina,90,90,84,83,84,82,423,16.9,17.6%
Foden,47,47,45,49,43,47,231,5.8,3.2%
Edwards,69,69,61,61,60,60,311,12.4,0.2%
Lukić,84,84,82,79,78,75,398,15.9,0.1%
Xhaka,89,89,87,81,84,79,420,16.8,2.3%
E.Le Fée,74,74,70,65,69,66,344,13.8,1.1%
Cullen,86,86,84,84,85,81,420,16.8,0.1%
Ndoye,62,62,59,61,60,63,305,10.2,0.3%
Mykolenko,88,88,88,78,85,80,419,16.8,4.5%
Kerkez,66,66,66,62,60,61,315,10.5,10.3%
Muniz,64,64,54,55,53,48,274,10.0,2.5%
De Ligt,81,81,83,77,76,71,388,15.5,1.0%
McGinn,57,57,59,58,58,56,288,10.5,0.6%
Martinez,0,0,91,92,91,93,367,14.7,0.5%
Kamara,82,82,80,75,76,70,383,15.3,0.2%
Wharton,70,70,67,64,63,64,328,13.1,0.5%
Burn,78,78,73,72,77,73,373,14.9,3.2%
Rodon,91,91,89,83,83,83,429,21.4,1.8%
Bassey,91,91,89,87,83,81,431,19.2,0.4%
N.Jackson,0,0,65,63,64,60,252,7.8,0.1%
André,88,88,84,80,81,78,411,14.9,0.1%
Toti,91,91,85,83,85,81,425,18.9,0.2%
James,61,61,57,54,56,54,282,10.3,4.6%
Lewis-Potter,69,69,64,59,58,58,308,12.3,0.5%
Pau,75,75,74,72,70,72,363,16.1,0.5%
Zubimendi,66,66,67,70,73,75,351,12.8,1.6%
Bogle,90,90,86,83,81,77,417,18.5,0.7%
J.Ramsey,55,55,55,52,55,49,266,9.7,0.6%
Henderson,74,74,75,64,62,59,334,13.4,0.4%
De Cuyper,67,67,63,69,63,57,319,14.2,7.6%
Gudmundsson,82,82,77,78,77,74,388,19.4,2.1%
Stach,70,70,69,70,66,67,342,13.7,0.1%
Raúl,35,35,47,45,49,51,227,7.0,2.4%
Van de Ven,85,85,81,80,81,77,404,18.0,18.4%
O'Brien,87,87,85,80,81,79,412,16.5,0.4%
Bentancur,75,75,73,64,68,68,348,12.7,0.1%
Elanga,51,51,49,51,51,46,248,7.1,9.6%
Havertz,50,50,54,47,47,41,239,6.4,1.3%
Ward-Prowse,58,58,55,60,56,60,289,9.6,0.4%
Beto,59,59,54,51,48,47,259,9.4,13.7%
Bernardo,62,62,56,60,58,56,292,9.0,0.6%
Ballard,90,90,86,84,83,77,420,18.7,0.3%
Dewsbury-Hall,57,57,57,64,61,56,295,11.8,0.9%
Sangaré,65,65,70,66,66,61,328,13.1,0.1%
Hume,87,87,84,78,81,78,408,18.1,0.3%
Robinson,41,41,59,67,78,79,324,13.0,6.4%
Gravenberch,0,0,77,78,78,78,311,11.3,0.1%
Doherty,75,75,73,67,71,72,358,15.9,0.2%
Dalot,76,76,72,69,71,67,355,15.8,2.7%
Amad,54,54,52,55,57,57,275,8.5,3.7%
Livramento,72,72,70,71,65,69,347,13.9,4.2%
Tete,65,65,64,61,58,55,303,13.5,0.2%
Walker,87,87,86,80,81,79,413,18.4,2.2%
Fofana,43,43,55,68,70,73,309,13.7,0.3%
Gnonto,56,56,55,54,49,53,267,9.7,0.6%
Reinildo,88,88,87,88,80,82,425,21.3,8.1%
Henry,76,76,74,69,64,65,348,15.5,0.2%
Trossard,28,28,37,45,45,38,193,5.5,1.5%
Martinelli,49,49,47,37,37,36,206,5.9,1.4%
Garner,64,64,65,65,63,63,320,12.8,0.1%
Yoro,76,76,71,67,70,64,348,15.5,1.1%
J.Palhinha,66,66,65,66,64,61,322,11.7,0.2%
Bergvall,60,60,54,56,57,56,283,10.3,0.2%
R.Gomes,58,58,57,52,54,57,278,12.4,0.1%
Smith Rowe,50,50,46,49,50,51,246,8.2,1.2%
Johnson,41,41,45,43,47,41,217,6.2,3.6%
Ugochukwu,73,73,71,69,68,64,345,13.8,0.0%
Berge,76,76,71,67,68,65,347,13.9,0.1%
White,70,70,61,50,47,43,271,9.9,0.9%
Yarmoliuk,63,63,63,59,55,54,294,11.8,0.1%
Tuanzebe,81,81,74,71,66,64,356,17.8,3.5%
Andreas,43,43,44,47,46,46,226,8.2,0.5%
Carvalho,38,38,41,43,41,43,206,8.2,0.3%
Gittens,42,42,35,40,36,36,189,5.8,0.3%
Diarra,65,65,59,63,60,61,308,11.2,0.1%
Walker-Peters,61,61,64,63,65,59,312,13.9,0.5%
Barnes,38,38,44,42,42,38,204,6.3,0.6%
Chalobah,59,59,64,45,47,47,262,10.5,0.7%
Diouf,60,60,56,50,42,40,248,11.0,3.7%
Hartman,68,68,66,65,62,57,318,15.9,0.4%
Barry,42,42,47,45,50,48,232,7.7,1.1%
Roberts,47,47,50,44,46,46,233,8.5,0.1%
Longstaff,65,65,61,58,62,57,303,12.1,0.3%
Adams,84,84,79,50,39,42,294,11.8,0.2%
Tanaka,62,62,58,62,59,63,304,12.2,0.4%
Dunk,62,62,66,59,59,55,301,13.4,1.0%
Bellegarde,46,46,45,44,44,46,225,8.2,0.1%
Digne,44,44,46,43,45,49,227,10.1,1.7%
Maatsen,47,47,44,45,46,43,225,10.0,0.9%
Smith,67,67,68,62,62,57,316,14.0,0.2%
Mavropanos,48,48,56,52,50,49,255,11.3,0.1%
Mayenda,43,43,46,49,44,42,224,8.1,0.4%
Ugarte,60,60,50,51,50,52,263,10.5,0.2%
Højlund,33,33,40,39,41,43,196,6.0,1.1%
Mainoo,52,52,53,53,53,49,260,10.4,1.0%
Kamada,46,46,45,42,43,45,221,8.8,0.1%
Richarlison,35,35,36,36,39,34,180,5.5,1.1%
Ampadu,63,63,62,67,60,59,311,12.4,0.1%
Kayode,63,63,54,57,47,40,261,11.6,0.3%
Scott,64,64,63,36,27,34,224,9.0,0.1%
Mazraoui,49,49,55,50,52,46,252,10.1,1.1%
Udogie,61,61,58,51,53,48,271,12.0,7.3%
Gündoğan,38,38,39,39,38,36,190,5.8,0.2%
Doku,35,35,33,33,33,35,169,5.2,1.2%
Sessegnon,56,56,48,40,32,34,210,7.6,0.2%
Talbi,46,46,44,40,41,39,210,8.4,0.2%
Odobert,36,36,35,38,35,38,182,6.6,0.1%
O.Dango,29,29,39,35,32,36,171,5.7,0.2%
Coppola,46,46,49,46,45,52,238,10.6,0.1%
Bijol,0,0,79,73,74,72,298,14.9,0.1%
J.Timber,30,30,41,46,48,57,222,8.1,2.2%
Darwin,23,23,30,32,26,33,144,4.4,1.2%
Wilson,30,30,29,29,34,29,151,5.0,0.2%
Ayari,41,41,44,34,42,41,202,8.1,0.3%
Hoever,46,46,47,42,44,48,227,11.3,2.7%
Hinshelwood,38,38,45,48,49,45,225,8.2,0.2%
Cook,0,0,0,80,79,75,234,9.4,0.0%
Nmecha,31,31,28,34,32,32,157,6.3,0.7%
Maguire,45,45,46,49,49,41,230,10.2,0.6%
J.Murphy,33,33,31,32,37,33,166,5.1,2.9%
C.Jones,49,49,28,32,30,30,169,6.1,0.1%
F.Kadıoğlu,38,38,47,42,41,42,210,9.3,0.3%
Sadiki,46,46,44,47,45,50,232,9.3,0.1%
Adama,36,36,38,35,31,34,174,6.3,0.4%
Matheus N.,35,35,42,37,35,38,187,6.8,0.6%
Hannibal,42,42,40,39,38,36,195,7.8,0.2%
Yates,35,35,38,43,45,43,204,8.2,0.2%
Spence,44,44,50,45,49,44,232,10.3,0.6%
Amdouni,40,40,36,31,33,32,172,6.9,0.4%
Mosquera,41,41,44,44,46,47,222,9.9,0.1%
Marc Guiu,31,31,33,33,33,34,164,7.3,7.6%
Merino,30,30,26,30,35,30,151,5.0,0.9%
Akanji,40,40,37,35,41,45,198,7.2,0.7%
Lewis,39,39,38,41,39,34,191,7.6,0.6%
Jensen,34,34,36,33,34,29,166,6.6,0.1%
S.Bueno,46,46,46,50,51,44,237,10.5,0.1%
Lerma,33,33,36,36,41,44,190,7.6,0.1%
Cherki,18,18,24,24,22,27,115,3.5,8.8%
Tosin,39,39,36,30,31,28,164,7.3,0.4%
Onana,29,29,36,35,39,42,181,7.2,1.7%
Jota,22,22,25,26,28,30,131,4.8,0.1%
Aaronson,28,28,29,32,34,28,151,5.5,0.1%
Bruun Larsen,31,31,26,30,26,26,139,5.1,0.1%
Seelt,67,67,56,60,33,9,225,11.3,0.4%
Hickey,26,26,33,42,49,48,198,9.9,0.8%
Trippier,29,29,30,36,31,33,159,6.4,1.5%
Hughes,37,37,32,32,36,32,169,6.8,0.1%
Gusto,29,29,32,29,29,35,154,6.2,2.1%
Patterson,29,29,35,34,39,39,176,7.8,0.2%
L.Guilherme,29,29,24,25,27,24,129,5.2,0.1%
O'Riley,23,23,25,21,25,25,119,4.3,0.2%
Savinho,18,18,20,22,21,24,105,3.0,1.9%
Mings,26,26,29,38,35,36,164,7.3,0.5%
Harrison,23,23,27,24,27,27,128,4.7,0.2%
G.Rodriguez,32,32,34,37,30,32,165,6.6,0.1%
Gruda,22,22,22,21,25,18,108,3.9,0.1%
Christie,0,0,0,25,61,61,147,5.9,0.5%
Milambo,16,16,25,25,29,31,126,4.6,0.1%
Mount,28,28,24,24,23,27,126,4.2,0.2%
Ramazani,19,19,19,27,25,23,113,4.5,0.1%
Guedes,16,16,18,22,24,25,105,3.8,0.1%
Robertson,20,20,22,22,25,29,118,3.9,2.1%
Estêvão,20,20,16,16,22,28,102,3.1,0.5%
Lavia,37,37,32,29,34,27,159,6.4,0.1%
Delap,30,30,12,13,16,14,85,2.6,4.7%
Bradley,16,16,20,22,25,30,113,4.5,0.6%
P.M.Sarr,24,24,22,26,28,28,128,5.1,2.0%
Botman,23,23,24,32,32,32,143,5.7,0.5%
Casemiro,21,21,25,26,23,29,124,4.5,0.2%
Castagne,24,24,30,26,37,33,150,6.7,0.2%
Koleosho,20,20,22,22,21,26,111,4.4,0.1%
Boscagli,26,26,26,28,31,32,143,6.4,0.2%
J.Araujo,26,26,27,30,28,36,147,7.3,1.3%
Álvarez,20,20,23,29,33,30,135,5.4,0.2%
Struijk,60,60,12,22,19,25,138,6.1,0.4%
Morato,21,21,23,31,34,33,142,6.3,0.1%
Bailey,14,14,18,17,16,21,86,3.1,0.5%
Foster,17,17,19,22,23,20,101,4.0,0.4%
Shaw,28,28,29,29,33,24,143,6.4,0.2%
Elliott,23,23,11,14,17,18,83,3.0,0.2%
Isidor,17,17,22,20,22,22,103,3.7,0.4%
Aké,21,21,23,28,25,28,125,4.5,0.5%
M.França,10,10,19,15,23,18,85,3.8,0.1%
Madueke,12,12,13,12,17,20,74,2.1,1.6%
Wieffer,22,22,23,21,21,23,110,4.4,0.1%
Brooks,18,18,21,21,14,16,90,3.6,0.2%
Danso,16,16,24,26,28,34,128,5.7,0.1%
Esse,13,13,16,20,19,14,82,3.3,0.3%
Awoniyi,13,13,16,17,15,17,78,2.8,0.8%
H.Traorè,21,21,27,12,9,9,78,3.5,0.3%
Igor Jesus,12,12,15,17,14,15,73,2.4,1.2%
Sinisterra,14,14,15,14,15,18,76,3.0,0.2%
Gomez,12,12,21,22,23,23,101,4.0,0.2%
Veltman,23,23,21,23,22,27,116,5.2,0.3%
L.Miley,13,13,28,23,20,14,98,4.4,3.2%
B.Badiashile,27,27,21,19,21,17,105,4.7,0.1%
Gomez,13,13,12,16,16,20,77,3.1,0.1%
Rigg,16,16,14,17,14,19,80,3.2,0.1%
Zirkzee,11,11,12,15,14,16,68,2.3,1.0%
Bornauw,38,38,14,16,19,26,113,5.7,0.3%
A.Ramsey,6,6,9,10,21,28,74,3.3,12.7%
Scarles,14,14,17,21,20,18,90,4.0,0.1%
M.Bizot,94,94,2,3,2,3,104,4.6,0.3%
Ekdal,22,22,18,23,21,22,106,5.3,0.3%
Lamptey,18,18,18,15,16,20,87,3.9,0.4%
Stones,10,10,17,17,23,24,91,3.3,0.5%
Ekwah,20,20,22,29,12,10,93,4.1,0.1%
Cairney,10,10,12,16,16,19,73,2.9,0.1%
Khusanov,15,15,16,23,20,18,92,3.3,0.3%
Calafiori,7,7,14,17,18,20,76,2.8,0.6%
Hato,10,10,14,18,19,24,85,3.4,0.2%
Summerville,0,0,0,0,21,47,68,2.5,0.0%
Nwaneri,10,10,11,13,10,12,56,2.0,0.4%
Kiwior,23,23,15,17,14,16,85,3.1,0.1%
Hee Chan,7,7,11,12,10,11,51,1.7,0.2%
Clyne,14,14,16,16,22,16,84,4.2,0.7%
N.Gonzalez,12,12,14,16,13,14,69,2.3,0.1%
Sosa,15,15,13,13,18,17,76,3.0,0.1%
Tzimas,7,7,4,9,12,13,45,1.6,0.1%
Devenny,9,9,12,10,14,13,58,2.6,1.7%
Osula,4,4,9,12,11,13,49,1.8,0.2%
Laurent,14,14,14,15,17,20,80,3.2,0.1%
King,7,7,12,13,14,14,60,2.7,0.3%
Barkley,7,7,11,13,12,12,55,2.2,0.3%
O'Nien,0,0,0,0,38,76,114,5.7,0.0%
Humphreys,11,11,16,20,17,20,84,4.2,0.3%
Philip,18,18,19,6,5,3,51,2.0,0.1%
Pinnock,7,7,12,14,18,21,72,3.2,0.3%
Pedro Lima,11,11,15,14,15,18,73,3.6,1.4%
Neil,12,12,13,19,17,18,79,3.2,0.1%
Obi,7,7,6,9,9,12,43,1.9,4.5%
Kroupi.Jr,9,9,10,7,8,8,42,1.9,1.3%
Nørgaard,12,12,14,10,11,13,60,2.2,0.7%
Byram,14,14,14,14,15,21,78,3.9,0.3%
Tchaouna,7,7,7,10,8,10,42,1.7,0.1%
Grealish,5,5,9,7,8,9,38,1.2,0.1%
Igor,12,12,15,15,17,16,75,3.3,0.1%
Chiesa,4,4,5,8,8,7,32,1.0,0.1%
Benson,6,6,9,8,9,11,43,1.6,0.0%
Bissouma,10,10,12,13,11,14,60,2.2,0.1%
Gruev,7,7,14,14,12,15,62,2.5,0.1%
Nkunku,8,8,4,6,7,5,30,1.0,0.3%
Ajer,11,11,13,13,13,16,66,2.9,0.2%
Diop,9,9,11,12,18,21,71,3.2,0.1%
Iroegbunam,7,7,11,11,16,11,56,2.2,0.1%
Endo,22,22,5,7,5,7,46,1.8,0.1%
Janelt,0,0,0,9,24,22,55,2.2,0.2%
Aznou,8,8,11,15,15,16,65,2.9,0.1%
Willock,0,0,0,0,13,34,47,1.9,0.2%
Mundle,0,0,0,8,17,20,45,1.8,0.1%
Gray,7,7,10,14,15,16,62,2.5,0.2%
Mepham,8,8,10,14,17,17,66,3.3,0.3%
March,0,0,0,10,12,18,40,1.3,0.1%
Buonanotte,4,4,5,7,5,8,29,1.2,0.3%
Heaven,5,5,9,15,13,12,54,2.7,2.0%
Ramsdale,6,6,10,13,13,13,55,2.2,0.3%
Lucas Pires,9,9,14,12,17,14,66,3.3,0.3%
Édouard,2,2,6,4,8,5,25,1.0,1.1%
Bayindir,45,45,7,3,2,4,61,2.4,0.5%
Josh Bowler,3,3,6,7,7,8,31,0.1,0.0%
H.Bueno,5,5,9,11,11,12,48,2.1,0.1%
Da Silva Moreira,4,4,6,4,7,8,29,1.3,0.2%
Huggins,12,12,16,19,10,4,61,3.0,0.3%
Doucouré,7,3,9,9,10,10,41,1.6,0.0%
Stamenic,3,3,6,8,11,14,42,1.9,0.1%
Bobb,5,5,4,5,6,7,27,1.0,0.1%
D.Essugo,5,5,6,7,9,8,35,1.6,0.1%
Tsimikas,5,5,6,6,7,11,35,1.4,0.1%
David Møller Wolfe,9,9,8,11,13,12,53,0.1,0.0%
A.García,5,5,5,7,9,7,33,1.6,1.0%
Nunes,2,2,6,6,5,5,24,1.0,0.1%
Y.Chermiti,2,2,4,7,6,6,25,1.0,0.2%
McAtee,2,2,4,4,6,5,21,0.8,0.1%
Roerslev,7,7,12,7,11,8,45,2.0,0.1%
Emerson,5,5,8,10,10,8,41,1.8,0.2%
Max Dowman,0,0,3,5,7,7,22,0.0,0.0%
Bogarde,5,5,7,10,11,12,45,2.3,0.4%
Poveda,6,6,5,6,4,4,25,1.0,0.1%
Bryan,2,2,3,6,5,5,21,0.8,0.1%
Keane,6,6,7,9,11,14,47,2.1,0.3%
Barnes,2,2,3,4,4,7,20,0.9,4.7%
O.Richards,5,5,9,9,10,8,41,1.8,0.1%
Benitez,5,5,7,6,12,8,38,1.9,0.4%
Hill,5,5,3,10,9,12,39,1.9,0.7%
Solomon,1,1,3,3,5,6,18,0.7,0.1%
Mamardashvili,0,0,6,8,8,12,34,1.5,0.7%
Roberts,8,8,6,8,8,12,42,1.9,0.1%
Mosquera,7,7,8,6,9,7,37,1.3,0.1%
Kovačić,0,0,0,0,10,23,33,1.1,0.0%
Sima,2,2,3,2,3,2,12,0.4,0.0%
Pembele,5,5,10,10,10,6,41,2.0,0.3%
Bamford,1,1,3,3,4,5,16,0.6,3.0%
Kalajdžić,2,2,2,3,6,3,16,0.6,0.2%
Cornet,2,2,2,5,3,3,15,0.6,0.1%
Soler,3,3,4,7,7,9,30,1.5,0.3%
Zinchenko,2,2,5,5,6,6,24,1.0,0.3%
Alex Moreno,3,3,4,4,8,7,26,1.3,11.3%
Carney Chukwuemeka,2,2,2,3,2,4,13,0.0,0.0%
Greenwood,1,1,2,2,4,4,13,0.5,0.1%
Martinez,0,0,0,0,2,31,33,1.3,0.6%
Davies,4,4,5,5,8,10,32,1.4,0.1%
Fer López,2,2,1,2,4,4,13,0.5,0.1%
Fábio Silva,1,1,1,1,3,5,11,0.4,0.7%
Patterson,3,3,3,9,8,8,31,1.4,0.5%
Hayden,1,1,3,4,6,1,15,0.7,0.1%
Raheem Sterling,1,1,2,2,1,4,10,0.0,0.0%
Irving,1,1,2,3,3,2,11,0.5,0.3%
Krafth,1,1,4,5,7,8,25,1.1,0.1%
Coleman,0,0,5,6,5,8,24,1.1,0.1%
Hjelde,0,0,0,0,12,19,31,1.6,0.0%
Peart-Harris,1,1,2,3,2,2,10,0.4,0.0%
Obafemi,1,1,2,1,5,2,11,0.5,0.7%
Marshall,1,1,2,1,2,2,8,0.4,0.8%
O’Reilly,1,1,2,1,2,3,9,0.4,0.2%
Gelhardt,0,0,1,1,4,3,9,0.4,0.3%
Nketiah,0,0,0,0,0,15,15,0.5,1.6%
Holding,1,1,2,7,6,4,20,1.0,0.3%
Collyer,0,0,2,3,4,5,14,0.6,0.2%
George,3,3,0,1,1,2,7,0.3,0.1%
Jordan,0,0,3,6,7,11,27,1.4,0.2%
Browne,1,1,4,3,2,3,13,0.6,0.1%
Acheampong,2,2,4,3,4,4,17,0.8,0.3%
Reed,1,1,1,1,2,4,9,0.4,0.3%
Schmidt,3,3,4,3,5,5,20,1.0,0.3%
Weiss,2,2,3,4,4,6,19,0.8,0.2%
Arrizabalaga,2,2,2,5,4,5,18,0.8,1.0%
Buendía,0,0,0,1,3,3,7,0.3,0.1%
Alese,0,0,0,0,12,13,25,1.3,0.0%
Neto,1,1,2,3,6,6,18,0.8,1.2%
Godo,0,0,1,1,2,2,6,0.3,0.1%
Jörgensen,2,2,1,5,2,4,14,0.6,0.2%
M.Sarr,2,2,4,3,4,5,18,0.8,0.1%
Darlow,2,2,3,3,4,4,16,0.8,6.3%
Ortega Moreno,2,2,2,2,3,4,13,0.5,0.5%
J.Cuenca,1,1,3,3,3,5,15,0.7,0.1%
Sarmiento,0,0,1,2,1,1,5,0.2,0.1%
Jair Cunha,0,0,3,3,4,7,17,0.8,0.1%
Triantis,2,2,2,4,1,0,9,0.4,0.1%
Kinsky,1,1,2,2,5,2,12,0.6,4.5%
David Datro Fofana,2,2,0,1,0,2,5,0.0,0.0%
Faivre,0,0,1,1,1,1,4,0.2,0.3%
Bajcetic,0,0,0,0,3,3,6,0.3,0.1%
Steele,1,1,1,1,4,4,11,0.5,0.4%
Trafford,0,0,0,3,5,4,12,0.5,3.2%
Armando Broja,1,1,0,0,2,1,4,0.0,0.0%
Johnstone,1,1,2,1,3,4,11,0.5,0.2%
Potts,1,1,2,2,1,3,9,0.4,0.7%
Foderingham,1,1,1,2,2,4,10,0.5,0.9%
Axel Disasi,2,2,2,3,2,3,12,0.0,0.0%
Malacia,0,0,1,2,2,2,7,0.3,0.4%
Ji-soo,0,0,1,2,4,3,10,0.5,0.2%
Redmond,0,0,1,0,1,2,4,0.2,0.9%
Lecomte,0,0,1,1,4,3,9,0.5,1.1%
Maghoma,0,0,2,1,1,1,5,0.2,0.1%
Valdimarsson,1,1,1,2,2,2,8,0.4,1.8%
Travers,0,0,1,2,2,3,8,0.4,0.2%
Delcroix,0,0,2,3,3,3,11,0.6,0.4%
Sambi,0,0,1,0,1,1,3,0.1,0.2%
Nelson,0,0,0,1,0,2,3,0.1,0.2%
Kuol,0,0,0,1,1,1,3,0.1,0.1%
N.Aguerd,0,0,1,4,2,1,8,0.4,0.1%
Amass,1,1,0,1,1,2,5,0.3,0.3%
Armstrong,0,0,1,1,1,2,5,0.2,0.4%
Renato Veiga,1,1,0,2,1,3,7,0.0,0.0%
Boly,0,0,1,3,3,1,8,0.4,0.6%
Winterburn,1,1,1,0,0,0,2,0.1,0.1%
Scarlett,0,0,0,1,1,0,2,0.1,0.9%
Ben Chilwell,0,0,0,1,2,1,4,0.0,0.0%
R.Williams,0,0,1,0,1,2,4,0.2,0.3%
Andrey Santos,0,0,0,1,1,1,3,0.1,0.4%
Pond,0,0,0,0,1,2,3,0.1,2.1%
C.Miguel,1,1,0,0,1,1,3,0.1,0.3%
Targett,0,0,0,1,1,0,2,0.1,0.5%
Sonne,0,0,1,0,0,1,2,0.1,0.2%
Watson,0,0,0,0,1,0,1,0.0,0.1%
J.Rak-Sakyi,0,0,0,1,0,0,1,0.0,0.1%
Hladký,1,1,0,0,0,1,2,0.1,0.4%
Moore,0,0,0,0,1,0,1,0.0,0.1%
Edozie,0,0,0,0,1,0,1,0.0,0.4%
Kone,0,0,0,0,0,1,1,0.0,0.1%
Aleksić,0,0,0,1,0,0,1,0.0,0.1%
Anderson,1,1,0,0,2,0,3,0.1,0.6%
Ba,0,0,0,0,0,1,1,0.0,0.4%
Worrall,0,0,0,0,1,1,2,0.1,0.2%
Gunn,0,0,0,1,0,0,1,0.1,0.1%
Yasin,0,0,0,0,0,1,1,0.1,0.3%
Akinmboni,0,0,0,0,0,1,1,0.1,0.4%
Abbott,0,0,0,0,0,1,1,0.1,0.3%
Odysseas,0,0,0,0,0,1,1,0.1,0.1%
Casey,0,0,0,0,0,1,1,0.1,0.8%
Hein,0,0,0,0,0,0,0,0.0,0.6%
Setford,0,0,0,0,0,0,0,0.0,0.2%
Clarke,0,0,0,0,0,0,0,0.0,0.6%
Kacurri,0,0,0,0,0,0,0,0.0,0.2%
Nichols,0,0,0,0,0,0,0,0.0,0.2%
Fábio Vieira,0,0,0,0,0,0,0,0.0,0.1%
Kabia,0,0,0,0,0,0,0,0.0,0.3%
G.Jesus,0,0,0,0,0,0,0,0.0,0.0%
Gauci,0,0,0,0,0,0,0,0.0,1.0%
Marschall,0,0,0,0,0,0,0,0.0,0.1%
Sousa,0,0,0,0,0,0,0,0.0,0.3%
Iling Jr,0,0,0,0,0,0,0,0.0,0.0%
Barrenechea,0,0,0,0,0,0,0,0.0,0.0%
Dobbin,0,0,0,0,0,0,0,0.0,0.1%
Broggio,0,0,0,0,0,0,0,0.0,0.3%
Dendoncker,0,0,0,0,0,0,0,0.0,0.4%
Jimoh-Aloba,0,0,0,0,0,0,0,0.0,0.1%
Young,0,0,0,0,0,0,0,0.0,0.6%
Dennis,0,0,0,0,0,0,0,0.0,0.7%
McKenna,0,0,0,0,0,0,0,0.0,0.2%
Paulsen,0,0,0,0,0,0,0,0.0,0.2%
Bevan,0,0,0,0,0,0,0,0.0,0.3%
Sadi,0,0,0,0,0,0,0,0.0,0.1%
Silcott-Duberry,0,0,0,0,0,0,0,0.0,0.3%
Enes Ünal,0,0,0,0,0,0,0,0.0,0.0%
Adu-Adjei,0,0,0,0,0,0,0,0.0,0.4%
Balcombe,0,0,0,0,0,0,0,0.0,0.3%
Cox,0,0,0,0,0,0,0,0.0,0.2%
Eyestone,0,0,0,0,0,0,0,0.0,0.1%
Arthur,0,0,0,0,0,0,0,0.0,0.4%
Fredrick,0,0,0,0,0,0,0,0.0,0.2%
Meghoma,0,0,0,0,0,0,0,0.0,0.2%
Onyeka,0,0,0,0,0,0,0,0.0,0.1%
Donovan,0,0,0,0,0,0,0,0.0,0.1%
Konak,0,0,0,0,0,0,0,0.0,0.2%
Trevitt,0,0,0,0,0,0,0,0.0,0.1%
Morgan,0,0,0,0,0,0,0,0.0,0.5%
McGill,0,0,0,0,0,0,0,0.0,0.3%
Rushworth,0,0,0,0,0,0,0,0.0,0.0%
Scherpen,0,0,0,0,0,0,0,0.0,0.0%
Estupiñan,0,0,0,0,0,0,0,0.0,0.2%
Webster,0,0,0,0,0,0,0,0.0,0.1%
Cashin,0,0,0,0,0,0,0,0.0,0.1%
Slater,0,0,0,0,0,0,0,0.0,0.2%
Tasker,0,0,0,0,0,0,0,0.0,0.2%
Enciso,0,0,0,0,0,0,0,0.0,0.2%
Milner,0,0,0,0,0,0,0,0.0,0.1%
Yalcouye,0,0,0,0,0,0,0,0.0,0.1%
Knight,0,0,0,0,0,0,0,0.0,0.1%
Mazilu,0,0,0,0,0,0,0,0.0,0.1%
Moran,0,0,0,0,0,0,0,0.0,0.1%
Ferguson,0,0,0,0,0,0,0,0.0,0.1%
Kostoulas,0,0,0,0,0,0,0,0.0,0.6%
Green,0,0,0,0,0,0,0,0.0,0.4%
Dodgson,0,0,0,0,0,0,0,0.0,0.2%
Sambo,0,0,0,0,0,0,0,0.0,0.2%
Boateng,0,0,0,0,0,0,0,0.0,0.1%
Churlinov,0,0,0,0,0,0,0,0.0,0.1%
Adewumi,0,0,0,0,0,0,0,0.0,0.1%
Banel,0,0,0,0,0,0,0,0.0,0.0%
Trésor,0,0,0,0,0,0,0,0.0,0.1%
Penders,0,0,0,0,0,0,0,0.0,0.0%
Slonina,0,0,0,0,0,0,0,0.0,0.1%
Colwill,0,0,0,0,0,0,0,0.0,4.5%
Anselmino,0,0,0,0,0,0,0,0.0,0.2%
Mudryk,0,0,0,0,0,0,0,0.0,0.0%
Paez,0,0,0,0,0,0,0,0.0,0.1%
Matthews,0,0,0,0,0,0,0,0.0,0.1%
Chadi Riad,0,0,0,0,0,0,0,0.0,0.0%
Kporha,0,0,0,0,0,0,0,0.0,0.2%
Agbinone,0,0,0,0,0,0,0,0.0,0.1%
Ahamada,0,0,0,0,0,0,0,0.0,0.1%
Ebiowei,0,0,0,0,0,0,0,0.0,0.1%
Ozoh,0,0,0,0,0,0,0,0.0,0.0%
Rodney,0,0,0,0,0,0,0,0.0,0.0%
Umeh,0,0,0,0,0,0,0,0.0,0.0%
Marsh,0,0,0,0,0,0,0,0.0,0.3%
Tyrer,0,0,0,0,0,0,0,0.0,0.2%
Dixon,0,0,0,0,0,0,0,0.0,0.3%
Welch,0,0,0,0,0,0,0,0.0,0.2%
Bates,0,0,0,0,0,0,0,0.0,0.1%
Ebere,0,0,0,0,0,0,0,0.0,0.0%
Heath,0,0,0,0,0,0,0,0.0,0.0%
Metcalfe,0,0,0,0,0,0,0,0.0,0.0%
Sherif,0,0,0,0,0,0,0,0.0,0.3%
Benda,0,0,0,0,0,0,0,0.0,0.1%
Amissah,0,0,0,0,0,0,0,0.0,0.2%
Harris,0,0,0,0,0,0,0,0.0,0.0%
Meslier,0,0,0,0,0,0,0,0.0,1.1%
Cairns,0,0,0,0,0,0,0,0.0,0.3%
Crew,0,0,0,0,0,0,0,0.0,0.1%
Gyabi,0,0,0,0,0,0,0,0.0,0.1%
Mateo Joseph,0,0,0,0,0,0,0,0.0,0.2%
Pécsi,0,0,0,0,0,0,0,0.0,0.1%
Woodman,0,0,0,0,0,0,0,0.0,0.1%
Nallo,0,0,0,0,0,0,0,0.0,0.2%
Ramsay,0,0,0,0,0,0,0,0.0,0.2%
Luis Díaz,0,0,0,0,0,0,0,0.0,0.8%
Doak,0,0,0,0,0,0,0,0.0,0.1%
McConnell,0,0,0,0,0,0,0,0.0,0.0%
Morton,0,0,0,0,0,0,0,0.0,0.0%
Nyoni,0,0,0,0,0,0,0,0.0,0.1%
Danns,0,0,0,0,0,0,0,0.0,0.2%
Bettinelli,0,0,0,0,0,0,0,0.0,0.2%
Vitor Reis,0,0,0,0,0,0,0,0.0,0.1%
Echeverri,0,0,0,0,0,0,0,0.0,0.1%
Nypan,0,0,0,0,0,0,0,0.0,0.1%
Phillips,0,0,0,0,0,0,0,0.0,0.1%
Harrison,0,0,0,0,0,0,0,0.0,0.0%
Heaton,0,0,0,0,0,0,0,0.0,0.4%
Mee,0,0,0,0,0,0,0,0.0,0.1%
D.Leon,0,0,0,0,0,0,0,0.0,0.1%
Fredricson,0,0,0,0,0,0,0,0.0,0.2%
Rashford,0,0,0,0,0,0,0,0.0,0.4%
Garnacho,0,0,0,0,0,0,0,0.0,0.2%
Antony,0,0,0,0,0,0,0,0.0,0.1%
Sancho,0,0,0,0,0,0,0,0.0,0.1%
Fitzgerald,0,0,0,0,0,0,0,0.0,0.0%
J.Fletcher,0,0,0,0,0,0,0,0.0,0.0%
Moorhouse,0,0,0,0,0,0,0,0.0,0.0%
Wheatley,0,0,0,0,0,0,0,0.0,0.2%
Gillespie,0,0,0,0,0,0,0,0.0,0.1%
Lascelles,0,0,0,0,0,0,0,0.0,0.1%
A.Murphy,0,0,0,0,0,0,0,0.0,0.8%
Ashby,0,0,0,0,0,0,0,0.0,0.2%
Pivas,0,0,0,0,0,0,0,0.0,0.2%
Antoñito C.,0,0,0,0,0,0,0,0.0,0.1%
White,0,0,0,0,0,0,0,0.0,0.1%
Neave,0,0,0,0,0,0,0,0.0,0.3%
Turner,0,0,0,0,0,0,0,0.0,1.3%
David Carmo,0,0,0,0,0,0,0,0.0,0.1%
Dominguez,0,0,0,0,0,0,0,0.0,0.0%
O'Brien,0,0,0,0,0,0,0,0.0,0.0%
Moore,0,0,0,0,0,0,0,0.0,0.6%
Nna Noukeu,0,0,0,0,0,0,0,0.0,0.2%
Cirkin,0,0,0,0,0,0,0,0.0,0.2%
Johnson,0,0,0,0,0,0,0,0.0,0.3%
H.Jones,0,0,0,0,0,0,0,0.0,0.1%
Matete,0,0,0,0,0,0,0,0.0,0.3%
Abdullahi,0,0,0,0,0,0,0,0.0,1.1%
Luís Hemir,0,0,0,0,0,0,0,0.0,0.3%
Rusyn,0,0,0,0,0,0,0,0.0,0.3%
Austin,0,0,0,0,0,0,0,0.0,0.3%
Dragusin,0,0,0,0,0,0,0,0.0,0.0%
Phillips,0,0,0,0,0,0,0,0.0,0.2%
Takai,0,0,0,0,0,0,0,0.0,0.4%
Vuskovic,0,0,0,0,0,0,0,0.0,2.1%
Son,0,0,0,0,0,0,0,0.0,2.0%
Maddison,0,0,0,0,0,0,0,0.0,2.5%
Kulusevski,0,0,0,0,0,0,0,0.0,0.0%
Min-hyeok,0,0,0,0,0,0,0,0.0,0.2%
Olusesi,0,0,0,0,0,0,0,0.0,0.2%
Lankshear,0,0,0,0,0,0,0,0.0,0.4%
Hegyi,0,0,0,0,0,0,0,0.0,0.4%
Earthy,0,0,0,0,0,0,0,0.0,0.2%
Orford,0,0,0,0,0,0,0,0.0,0.2%
Bentley,0,0,0,0,0,0,0,0.0,1.2%
King,0,0,0,0,0,0,0,0.0,2.7%
Meupiyou,0,0,0,0,0,0,0,0.0,0.1%
B.Traore,0,0,0,0,0,0,0,0.0,0.0%
Chirewa,0,0,0,0,0,0,0,0.0,0.3%
Gonzalez,0,0,0,0,0,0,0,0.0,1.4%
Hodge,0,0,0,0,0,0,0,0.0,0.3%
Chiwome,0,0,0,0,0,0,0,0.0,0.1%
Fraser,0,0,0,0,0,0,0,0.0,2.6%
Josh Wilson-Esbrand,0,0,0,0,0,0,0,0.0,0.0%
Issa Kaboré,0,0,0,0,0,0,0,0.0,0.0%
Alfie Gilchrist,0,0,0,0,0,0,0,0.0,0.0%
Alfie Devine,0,0,0,0,0,0,0,0.0,0.0%
Emmanuel Dennis,0,0,0,0,0,0,0,0.0,0.0%
Hindolo Mustapha,0,0,0,0,0,0,0,0.0,0.0%
Callum Doyle,0,0,0,0,0,0,0,0.0,0.0%
