Name,xMins,GW1,GW2,GW3,GW4,GW5,Total,xMins/£M,Elite%
M.Salah,90,90,87,88,85,82,432,6.0,58.1%
Palmer,89,89,87,87,87,83,433,8.2,54.2%
Haaland,88,88,86,84,79,76,413,5.9,20.5%
Saka,86,86,83,83,80,81,413,8.3,15.1%
B.Fernandes,89,89,86,87,83,82,427,9.5,14.7%
Marmoush,75,75,75,69,68,65,352,8.3,13.6%
Eze,86,86,82,82,78,78,406,10.8,9.2%
Wirtz,87,87,80,75,76,80,398,9.4,32.5%
Watkins,82,82,77,77,75,76,387,8.6,17.3%
Bowen,91,91,86,81,81,83,422,10.6,20.3%
Mateta,86,86,81,83,78,79,407,10.9,6.3%
Gakpo,70,70,68,67,64,71,340,9.1,5.3%
Gibbs-White,88,88,87,83,84,81,423,11.3,4.8%
Semenyo,88,88,85,83,76,80,412,11.8,5.0%
Virgil,91,91,88,87,83,81,430,14.3,24.5%
Evanilson,83,83,80,75,77,77,392,11.2,2.6%
Enzo,90,90,90,88,85,82,435,13.4,4.0%
Ødegaard,84,84,81,80,76,73,394,9.8,3.3%
Tielemans,85,85,85,81,79,80,410,13.7,1.8%
Sarr,83,83,81,78,73,72,387,11.9,2.3%
Rogers,76,76,83,80,78,77,394,11.3,23.1%
Solanke,65,65,77,73,75,69,359,9.6,11.1%
Wood,80,80,79,72,74,74,379,10.1,16.4%
Strand Larsen,85,85,79,80,77,74,395,12.2,5.9%
Ndiaye,78,78,76,72,72,71,369,11.4,13.0%
Anderson,84,84,86,79,86,80,415,15.1,4.9%
L.Paquetá,78,78,76,74,71,73,372,12.4,1.1%
Mitoma,82,82,79,77,81,79,398,12.2,6.1%
Frimpong,79,79,72,70,73,73,367,12.2,25.5%
Cunha,78,78,74,70,75,69,366,9.2,10.3%
Mac Allister,82,82,78,75,79,73,387,11.9,1.5%
Schade,79,79,77,71,72,66,365,10.4,1.9%
Rice,81,81,81,74,76,76,388,11.9,7.5%
Damsgaard,85,85,80,76,79,78,398,13.3,1.2%
Murillo,89,89,87,86,81,82,425,15.5,4.9%
Mbeumo,80,80,79,75,74,72,380,9.5,16.7%
Joelinton,90,90,87,82,81,82,422,14.1,0.5%
Kudus,78,78,71,68,70,65,352,10.8,24.9%
Bruno G.,91,91,83,84,80,82,420,12.9,1.5%
Raya,92,92,93,91,91,87,454,16.5,17.8%
Neto,78,78,71,66,69,65,349,10.0,4.1%
Kluivert,71,71,71,62,60,62,326,9.3,4.8%
Welbeck,70,70,70,76,65,63,344,10.6,7.6%
Lacroix,91,91,86,88,83,81,429,17.2,1.1%
A.Becker,93,93,88,85,85,83,434,15.8,11.1%
Cucurella,92,92,88,83,79,83,425,14.2,18.9%
Iwobi,84,84,77,75,77,77,390,12.0,1.5%
N.Williams,87,87,89,84,82,78,420,16.8,5.0%
Muñoz,90,90,87,84,84,80,425,15.5,8.4%
Gordon,73,73,68,61,59,61,322,8.6,3.1%
Sánchez,94,94,92,92,90,90,458,18.3,15.9%
Konaté,84,84,81,78,75,75,393,14.3,2.9%
Caicedo,87,87,86,87,84,82,426,15.5,7.0%
Gyökeres,46,46,49,52,54,55,256,5.7,22.9%
Ederson M.,95,95,89,88,90,87,449,16.3,3.7%
Schär,90,90,87,80,80,85,422,15.3,2.4%
Andersen,92,92,88,86,83,84,433,19.2,1.5%
Collins,89,89,89,88,87,83,436,17.4,1.7%
Gabriel,72,72,77,81,80,82,392,13.1,21.5%
Ekitiké,53,53,52,54,54,51,264,6.2,5.6%
Georginio,63,63,58,57,59,58,295,9.8,0.4%
Pedro Porro,82,82,81,74,72,72,381,13.9,11.6%
Sels,93,93,92,92,90,92,459,18.4,18.0%
Tarkowski,90,90,91,86,86,86,439,16.0,5.1%
Saliba,91,91,88,82,80,82,423,14.1,13.9%
Milenković,89,89,90,85,81,78,423,15.4,9.2%
Areola,94,94,93,93,91,92,463,20.6,5.3%
Richards,87,87,84,86,81,80,418,18.6,1.0%
Van den Berg,92,92,88,86,82,85,433,19.2,0.4%
Tonali,90,90,86,85,80,77,418,15.2,2.3%
Wilson,75,75,68,63,57,56,319,11.6,1.4%
Guéhi,91,91,88,86,85,86,436,19.4,13.2%
Estève,91,91,91,89,91,88,450,22.5,13.5%
Leno,92,92,91,91,89,91,454,18.2,1.7%
Pickford,94,94,92,92,91,89,458,16.7,12.1%
Gomes,88,88,84,84,81,76,413,15.0,0.1%
Vicario,93,93,93,90,89,88,453,18.1,3.4%
Verbruggen,94,94,92,91,91,90,458,20.4,6.7%
Kelleher,93,93,92,90,90,90,455,20.2,30.8%
Petrović,91,91,90,93,90,89,453,20.1,4.0%
Anthony,77,77,72,68,71,67,355,12.9,0.1%
J.Arias,61,61,66,68,68,70,333,12.1,1.2%
Baleba,84,84,86,83,79,80,412,16.5,5.0%
Gana,87,87,84,82,79,83,415,15.1,0.1%
Hall,87,87,83,78,77,78,403,14.7,2.7%
Konsa,90,90,88,85,88,83,434,19.3,23.6%
Thiago,66,66,63,56,48,52,285,9.5,1.2%
Gvardiol,74,74,75,70,65,69,353,11.8,17.4%
Kilman,89,89,85,83,85,84,426,18.9,0.4%
Minteh,64,64,65,63,58,62,312,10.4,1.3%
McNeil,76,76,74,71,74,73,368,12.3,0.8%
Henderson,89,89,86,88,85,86,434,17.4,3.5%
Aït-Nouri,70,70,58,65,63,61,317,10.6,23.0%
José Sá,94,94,92,91,89,91,457,20.3,2.3%
Senesi,85,85,83,80,83,80,411,18.3,0.7%
Romero,89,89,84,83,84,81,421,16.8,1.8%
Adingra,76,76,78,77,69,71,371,13.5,2.6%
Roefs,94,94,92,93,89,91,459,20.4,0.1%
E.Le Fée,78,78,79,70,74,72,373,14.9,1.0%
Branthwaite,91,91,85,84,80,78,418,15.2,1.9%
Reijnders,76,76,68,72,61,64,341,12.4,4.5%
Munetsi,78,78,75,72,75,73,373,13.6,0.1%
Cash,82,82,75,73,73,72,375,16.7,1.7%
Dúbravka,91,91,91,92,87,88,449,22.4,21.4%
Perri,93,93,91,92,91,90,457,20.3,0.3%
Dorgu,82,82,80,80,75,78,395,17.6,5.8%
Malen,59,59,60,57,50,47,273,9.9,3.1%
Van Hecke,91,91,88,88,81,86,434,19.3,1.2%
Tel,55,55,53,59,54,53,274,8.4,0.2%
Wan-Bissaka,88,88,88,85,86,82,429,19.1,31.1%
Zabarnyi,92,92,88,85,83,83,431,17.2,0.5%
Isak,0,0,32,60,79,76,247,4.7,25.9%
Hudson-Odoi,75,75,71,67,69,64,346,11.5,1.7%
Szoboszlai,65,65,50,49,53,52,269,8.3,1.8%
Pope,83,83,87,84,83,77,414,16.6,3.8%
Aina,89,89,89,85,83,80,426,17.0,17.4%
Füllkrug,65,65,62,64,57,59,307,10.2,2.1%
Lukić,83,83,77,78,75,76,389,15.6,0.1%
Lewis-Skelly,79,79,74,73,69,64,359,13.1,5.4%
Ndoye,64,64,62,66,61,63,316,10.5,0.3%
João Pedro,66,66,56,55,51,49,277,7.4,52.3%
Agbadou,91,91,87,83,82,84,427,19.0,0.3%
Onana,92,46,87,91,92,93,409,16.4,0.1%
Todibo,88,88,85,82,83,79,417,18.5,0.1%
Cullen,87,87,83,83,82,82,417,16.7,0.1%
Bassey,90,90,87,83,85,87,432,19.2,0.4%
Mitchell,78,78,76,73,71,74,372,14.9,1.0%
Dewsbury-Hall,67,67,64,71,66,70,338,13.5,1.2%
Piroe,69,69,66,63,63,60,321,11.7,3.2%
Souček,70,70,73,66,71,71,351,11.7,0.9%
Truffert,89,89,84,83,81,84,421,18.7,1.2%
Foden,50,50,45,48,48,47,238,6.0,3.2%
Muniz,65,65,60,55,52,49,281,10.2,2.5%
Edwards,65,65,64,62,63,58,312,12.5,0.2%
Xhaka,88,88,86,84,85,84,427,17.1,2.3%
Alcaraz,64,64,63,63,62,61,313,11.4,0.3%
Kamara,82,82,81,77,73,74,387,15.5,0.2%
Rúben,82,82,80,70,71,66,369,13.4,2.5%
Burn,74,74,75,73,73,71,366,14.6,3.2%
Bernardo,65,65,68,66,56,58,313,9.6,0.6%
André,86,86,84,83,81,78,412,15.0,0.1%
N.Jackson,0,0,71,62,63,66,262,8.1,0.1%
Tavernier,62,62,58,54,56,51,281,10.2,0.4%
Martinez,0,0,92,89,93,93,367,14.7,0.5%
De Ligt,84,84,80,78,77,73,392,15.7,1.1%
Bentancur,76,76,76,68,68,69,357,13.0,0.1%
Elanga,58,58,56,54,45,46,259,7.4,9.4%
De Cuyper,68,68,70,65,60,64,327,14.5,7.3%
James,65,65,62,63,63,63,316,11.5,0.8%
Beto,60,60,58,50,48,51,267,9.7,13.5%
Mykolenko,86,86,80,78,81,80,405,16.2,4.4%
Kerkez,67,67,62,62,59,61,311,10.4,10.1%
Wissa,35,35,46,50,59,58,248,6.6,6.9%
James,65,65,60,57,56,52,290,10.5,4.5%
Ballard,92,92,86,86,77,76,417,18.5,0.3%
Van de Ven,86,86,85,78,79,78,406,18.0,18.9%
Zubimendi,70,70,76,68,68,70,352,12.8,1.6%
Wharton,66,66,62,68,65,66,327,13.1,0.5%
Henderson,76,76,74,69,60,59,338,13.5,0.4%
O'Brien,87,87,83,85,78,77,410,16.4,0.4%
Lewis-Potter,57,57,62,56,58,56,289,11.6,0.5%
Hume,90,90,87,83,82,82,424,18.8,0.3%
Pau,77,77,73,66,75,70,361,16.0,0.5%
Livramento,71,71,70,73,70,67,351,14.0,4.1%
Robinson,41,41,58,72,83,79,333,13.3,6.3%
Raúl,34,34,44,45,51,49,223,6.9,2.4%
Rodon,91,91,88,85,85,82,431,21.6,1.8%
Toti,87,87,87,82,82,82,420,18.7,0.2%
Bogle,85,85,81,78,81,77,402,17.9,0.6%
Armando Broja,56,56,58,54,50,55,273,0.5,0.0%
Carvalho,44,44,49,48,42,48,231,9.2,0.3%
Stach,73,73,70,67,68,64,342,13.7,0.1%
Guessand,36,36,40,46,44,47,213,6.6,0.0%
Flemming,55,55,55,52,56,57,275,10.0,0.2%
Havertz,45,45,53,49,46,47,240,6.4,1.3%
Barnes,53,53,42,44,41,41,221,6.8,0.6%
Gudmundsson,81,81,80,76,75,70,382,19.1,2.2%
Sangaré,65,65,66,66,67,65,329,13.2,0.1%
Amad,56,56,56,57,62,51,282,8.7,3.7%
Tete,68,68,66,63,55,56,308,13.7,0.2%
Mosquera,80,80,75,71,67,70,363,16.1,0.1%
Ward-Prowse,58,58,58,61,56,58,291,9.7,0.4%
Smith Rowe,62,62,51,53,44,50,260,8.7,1.2%
Fofana,41,41,61,72,71,68,313,13.9,0.3%
Talbi,63,63,60,60,55,54,292,11.7,0.2%
Yoro,75,75,74,73,67,67,356,15.8,1.1%
Gravenberch,0,0,79,77,76,75,307,11.2,0.1%
Walker,86,86,84,79,79,79,407,18.1,2.2%
Reinildo,89,89,86,82,84,77,418,20.9,7.9%
McGinn,52,52,51,49,46,52,250,9.1,0.6%
Andreas,42,42,48,44,49,44,227,8.3,0.5%
Bergvall,62,62,60,52,54,50,278,10.1,0.2%
White,72,72,60,55,49,49,285,10.4,0.9%
Trossard,33,33,39,45,43,40,200,5.7,1.5%
Martinelli,53,53,44,37,37,36,207,5.9,1.4%
Gnonto,56,56,49,54,52,54,265,9.6,0.6%
Garner,64,64,61,66,63,61,315,12.6,0.1%
Henry,74,74,72,69,65,63,343,15.2,0.2%
Doherty,68,68,69,68,68,63,336,14.9,0.2%
Chalobah,68,68,58,57,48,48,279,11.2,0.8%
Yarmoliuk,67,67,63,58,54,52,294,11.8,0.1%
Johnson,48,48,44,44,42,46,224,6.4,3.6%
Dunk,69,69,72,64,63,62,330,14.7,1.1%
Berge,69,69,68,68,63,66,334,13.4,0.1%
Ugochukwu,72,72,68,66,67,63,336,13.4,0.0%
Tuanzebe,80,80,73,73,69,59,354,17.7,3.4%
Longstaff,65,65,64,61,63,65,318,12.7,0.3%
Adams,86,86,81,54,40,44,305,12.2,0.2%
Barry,37,37,45,46,51,45,224,7.5,1.1%
Walker-Peters,66,66,62,72,65,61,326,14.5,0.5%
J.Ramsey,47,47,42,46,46,45,226,8.2,0.6%
Diarra,58,58,61,62,57,57,295,10.7,0.1%
Rodrigo,16,16,36,59,68,82,261,8.0,1.5%
Kamada,46,46,49,48,49,45,237,9.5,0.1%
Hartman,67,67,63,60,63,57,310,15.5,0.3%
Mayenda,59,59,46,52,41,40,238,8.7,0.4%
Diouf,55,55,59,47,43,44,248,11.0,4.1%
Richarlison,39,39,39,38,41,39,196,6.0,1.1%
Gittens,42,42,35,33,34,33,177,5.4,0.3%
Bellegarde,42,42,44,46,48,42,222,8.1,0.1%
J.Palhinha,48,48,58,60,63,65,294,10.7,0.2%
Gündoğan,50,50,45,41,37,35,208,6.4,0.2%
Maatsen,45,45,49,48,47,45,234,10.4,0.9%
Digne,44,44,45,46,45,45,225,10.0,1.8%
Smith,62,62,61,61,65,62,311,13.8,0.2%
Mainoo,55,55,55,52,52,53,267,10.7,0.9%
Ugarte,54,54,56,51,48,49,258,10.3,0.2%
Dalot,61,61,57,62,60,57,297,13.2,2.7%
Tanaka,65,65,58,62,60,54,299,12.0,0.4%
Ampadu,63,63,60,60,61,60,304,12.2,0.1%
Odobert,41,41,38,38,36,40,193,7.0,0.1%
Sessegnon,56,56,44,43,35,38,216,7.9,0.2%
Scott,65,65,63,36,29,32,225,9.0,0.1%
O.Dango,27,27,35,34,43,38,177,5.9,0.2%
Doku,37,37,33,35,33,36,174,5.4,1.2%
Højlund,39,39,40,41,38,35,193,5.9,1.0%
Kayode,62,62,54,52,46,36,250,11.1,0.3%
J.Murphy,42,42,36,38,38,38,192,5.9,2.9%
C.Jones,51,51,34,36,34,33,188,6.8,0.1%
David Møller Wolfe,66,66,55,58,55,58,292,0.6,0.0%
Mavropanos,42,42,48,51,52,51,244,10.8,0.1%
Ayari,40,40,40,43,45,42,210,8.4,0.3%
Bijol,0,0,78,73,75,76,302,15.1,0.2%
Udogie,51,51,50,53,47,50,251,11.2,6.8%
Hinshelwood,50,50,47,45,51,46,239,8.7,0.2%
Estêvão,31,31,28,26,38,36,159,4.9,1.1%
Maguire,54,54,51,53,53,42,253,11.2,0.6%
J.Timber,35,35,42,41,49,51,218,7.9,2.2%
F.Kadıoğlu,49,49,43,45,40,41,218,9.7,0.3%
Wilson,32,32,32,33,30,31,158,5.3,0.3%
Cook,0,0,0,80,77,71,228,9.1,0.0%
Spence,47,47,49,47,48,52,243,10.8,0.6%
Adama,30,30,31,31,36,37,165,6.0,0.4%
Yates,37,37,38,40,43,43,201,8.0,0.2%
Lerma,37,37,41,41,44,44,207,8.3,0.1%
Cherki,27,27,22,29,24,26,128,3.9,8.6%
Hannibal,41,41,41,36,40,37,195,7.8,0.2%
Lewis,38,38,41,39,44,41,203,8.1,0.6%
Tosin,50,50,40,38,29,29,186,8.3,0.4%
Nmecha,29,29,31,32,26,30,148,5.9,0.7%
Coppola,35,35,40,41,42,38,196,8.7,0.1%
Matheus N.,36,36,38,35,40,31,180,6.5,0.6%
Sadiki,38,38,41,43,46,42,210,8.4,0.1%
Aaronson,28,28,34,33,34,33,162,5.9,0.1%
Jensen,36,36,38,32,30,32,168,6.7,0.1%
Amdouni,32,32,34,31,28,30,155,6.2,0.4%
Mazraoui,36,36,44,40,40,37,197,7.9,1.1%
L.Guilherme,29,29,27,34,29,22,141,5.6,0.1%
Osula,51,51,33,24,9,15,132,4.8,0.2%
Merino,26,26,26,28,28,31,139,4.6,0.9%
Onana,34,34,28,37,37,40,176,7.0,1.7%
Roberts,29,29,29,28,28,32,146,5.3,0.1%
Hoever,30,30,31,40,40,36,177,8.8,2.7%
Bruun Larsen,22,22,24,31,24,30,131,4.8,0.1%
Gusto,25,25,32,29,35,36,157,6.3,2.1%
Hickey,28,28,32,42,45,51,198,9.9,0.7%
Hughes,34,34,35,35,37,29,170,6.8,0.1%
Ramazani,25,25,25,29,26,27,132,5.3,0.1%
Savinho,23,23,21,26,23,20,113,3.2,1.9%
Seelt,60,60,51,54,31,9,205,10.3,0.4%
Jota,21,21,24,26,25,25,121,4.4,0.1%
Milambo,16,16,23,27,31,36,133,4.8,0.1%
O'Riley,20,20,23,24,26,23,116,4.2,0.2%
Akanji,33,33,34,28,34,35,164,6.0,0.7%
P.M.Sarr,30,30,29,31,30,29,149,6.0,2.1%
Gruda,20,20,21,21,25,22,109,4.0,0.1%
Mount,24,24,30,26,28,24,132,4.4,0.2%
Elliott,28,28,16,16,23,24,107,3.9,0.2%
Patterson,24,24,34,35,38,36,167,7.4,0.2%
Boscagli,29,29,32,37,37,31,166,7.4,0.2%
Mings,28,28,35,33,33,35,164,7.3,0.5%
Trippier,26,26,30,29,28,34,147,5.9,1.5%
G.Rodriguez,35,35,32,31,29,36,163,6.5,0.1%
N.Gonzalez,46,46,38,29,22,10,145,4.8,0.1%
Delap,31,31,13,18,17,14,93,2.9,4.6%
Harrison,24,24,22,28,24,27,125,4.5,0.2%
R.Gomes,25,25,27,30,27,30,139,6.2,0.1%
Isidor,24,24,29,24,22,27,126,4.6,0.3%
Hato,17,17,26,32,36,39,150,6.0,0.2%
Álvarez,24,24,27,32,32,34,149,6.0,0.2%
Botman,22,22,25,31,33,32,143,5.7,0.5%
Casemiro,28,28,22,27,26,27,130,4.7,0.2%
Christie,0,0,0,19,53,57,129,5.2,0.5%
Castagne,24,24,29,29,35,30,147,6.5,0.2%
Bradley,18,18,20,27,23,27,115,4.6,0.6%
Marc Guiu,11,11,21,23,30,29,114,5.1,9.8%
J.Araujo,30,30,31,31,30,33,155,7.8,1.3%
Esse,15,15,19,20,24,22,100,4.0,0.2%
Shaw,34,34,31,32,26,30,153,6.8,0.2%
Chiesa,16,16,14,14,16,18,78,2.4,0.1%
Robertson,18,18,19,22,25,24,108,3.6,2.0%
Koleosho,20,20,22,21,20,20,103,4.1,0.1%
S.Bueno,21,21,27,33,36,39,156,6.9,0.1%
Madueke,10,10,11,16,18,21,76,2.2,1.6%
Gomez,15,15,18,24,31,30,118,4.7,0.2%
Morato,15,15,25,27,31,35,133,5.9,0.1%
Struijk,64,64,14,15,17,23,133,5.9,0.4%
Wieffer,22,22,23,24,23,21,113,4.5,0.1%
Fer López,16,16,17,16,19,20,88,3.2,0.1%
L.Miley,19,19,25,26,21,17,108,4.8,3.2%
Brooks,16,16,20,15,16,18,85,3.4,0.1%
Aké,21,21,21,20,24,29,115,4.2,0.6%
Danso,18,18,25,26,28,24,121,5.4,0.1%
Igor Jesus,15,15,14,15,16,18,78,2.6,1.2%
H.Traorè,22,22,25,13,11,12,83,3.7,0.3%
Sinisterra,13,13,19,15,17,13,77,3.1,0.2%
Awoniyi,12,12,14,16,16,14,72,2.6,0.8%
Lamptey,15,15,22,21,21,17,96,4.3,0.4%
Bornauw,43,43,14,17,26,22,122,6.1,0.3%
Devenny,11,11,14,18,19,14,76,3.4,1.7%
Zirkzee,10,10,11,17,18,18,74,2.5,1.0%
Rigg,15,15,16,19,19,14,83,3.3,0.1%
Gomez,11,11,14,17,18,19,79,3.2,0.1%
Stones,21,21,19,21,19,21,101,3.7,0.5%
Ekdal,17,17,22,21,25,25,110,5.5,0.3%
Clyne,14,14,16,23,27,23,103,5.2,0.7%
Veltman,23,23,21,21,21,20,106,4.7,0.3%
Calafiori,7,7,15,20,23,18,83,3.0,0.6%
Hee Chan,9,9,9,16,12,16,62,2.1,0.2%
M.Bizot,94,94,1,3,3,2,103,4.6,0.3%
Sosa,17,17,18,17,18,19,89,3.6,0.1%
Khusanov,18,18,18,19,17,23,95,3.5,0.3%
Nwaneri,9,9,11,9,16,14,59,2.1,0.4%
Ekwah,18,18,24,24,19,7,92,4.1,0.1%
Scarles,15,15,16,17,18,18,84,3.7,0.1%
Cairney,10,10,11,15,15,17,68,2.7,0.1%
Aznou,13,13,17,20,20,21,91,4.0,0.1%
A.Ramsey,3,3,9,11,15,25,63,2.8,12.5%
Foster,10,10,12,12,14,13,61,2.4,0.4%
King,6,6,13,14,14,14,61,2.7,0.4%
Summerville,0,0,0,0,23,41,64,2.3,0.0%
Kiwior,20,20,15,14,14,14,77,2.8,0.1%
Philip,17,17,22,7,5,5,56,2.2,0.1%
Bailey,4,4,8,9,9,14,44,1.6,0.5%
Laurent,9,9,13,15,20,18,75,3.0,0.1%
Lavia,15,15,15,14,15,16,75,3.0,0.1%
Kroupi.Jr,10,10,11,8,7,11,47,2.1,1.2%
Igor,14,14,15,16,20,20,85,3.8,0.1%
Humphreys,12,12,18,20,14,18,82,4.1,0.3%
Pinnock,10,10,11,15,18,18,72,3.2,0.3%
Grealish,7,7,8,7,11,10,43,1.3,0.1%
Byram,14,14,17,14,15,20,80,4.0,0.3%
O'Nien,0,0,0,0,31,70,101,5.0,0.0%
Nørgaard,10,10,8,13,14,15,60,2.2,0.8%
Neil,13,13,17,15,16,16,77,3.1,0.1%
Diop,8,8,15,15,19,18,75,3.3,0.1%
Bissouma,10,10,14,13,11,12,60,2.2,0.1%
Endo,19,19,7,9,8,8,51,2.0,0.1%
Gray,9,9,12,15,12,19,67,2.7,0.2%
Tzimas,4,4,6,7,7,8,32,1.2,0.1%
Gruev,10,10,9,12,14,17,62,2.5,0.1%
Barkley,5,5,8,9,9,11,42,1.7,0.3%
Obi,4,4,5,9,7,10,35,1.6,4.2%
Tchaouna,5,5,7,6,9,11,38,1.5,0.1%
Nkunku,9,9,4,6,4,5,28,0.9,0.2%
Mepham,9,9,13,16,13,17,68,3.4,0.3%
Bayindir,51,51,6,3,3,4,67,2.7,0.5%
Édouard,4,4,5,7,8,5,29,1.2,1.1%
Ajer,12,12,12,11,11,15,61,2.7,0.2%
Benson,4,4,6,6,10,9,35,1.3,0.0%
Iroegbunam,8,8,12,10,11,11,52,2.1,0.1%
Buonanotte,5,5,7,5,6,6,29,1.2,0.3%
Lucas Pires,8,8,14,14,14,15,65,3.3,0.3%
Bobb,5,5,4,5,9,7,30,1.1,0.1%
Josh Bowler,3,3,6,8,7,10,34,0.1,0.0%
Heaven,8,8,12,12,11,14,57,2.9,1.9%
Janelt,0,0,0,7,23,21,51,2.0,0.2%
March,0,0,0,6,15,17,38,1.3,0.1%
Da Silva Moreira,3,3,5,9,8,8,33,1.5,0.2%
Willock,0,0,0,0,14,28,42,1.7,0.2%
Nunes,3,3,5,6,5,6,25,1.0,0.1%
Ramsdale,7,7,8,9,13,15,52,2.1,0.4%
Poveda,7,7,9,6,4,6,32,1.3,0.1%
D.Essugo,5,5,6,6,8,9,34,1.5,0.1%
Huggins,16,16,14,18,7,2,57,2.9,0.3%
Roerslev,8,8,10,11,9,10,48,2.1,0.1%
Tsimikas,5,5,5,8,6,11,35,1.4,0.1%
Emerson,9,9,10,8,7,8,42,1.9,0.2%
Mundle,0,0,0,6,15,14,35,1.4,0.1%
Fábio Silva,2,2,3,6,5,6,22,0.9,0.6%
Kalajdžić,2,2,5,5,4,6,22,0.9,0.2%
Keane,5,5,10,8,12,14,49,2.2,0.3%
A.García,5,5,7,4,6,9,31,1.6,0.9%
Watson,4,4,5,5,4,2,20,0.8,0.1%
Stamenic,3,3,7,8,10,9,37,1.6,0.1%
Bogarde,7,7,6,8,9,12,42,2.1,0.4%
McAtee,2,2,3,4,5,5,19,0.7,0.1%
M.França,0,0,0,0,9,17,26,1.2,0.1%
Y.Chermiti,1,1,3,5,6,6,21,0.8,0.2%
Bryan,3,3,3,4,5,4,19,0.8,0.1%
Pembele,8,8,12,9,10,7,46,2.3,0.3%
Cornet,2,2,4,5,5,3,19,0.8,0.1%
O.Richards,3,3,7,10,11,10,41,1.8,0.1%
Benitez,3,3,12,8,7,8,38,1.9,0.4%
Solomon,3,3,4,3,3,5,18,0.7,0.1%
Roberts,6,6,6,12,10,11,45,2.0,0.1%
Max Dowman,0,0,3,4,5,6,18,0.0,0.0%
Mosquera,6,6,8,6,7,11,38,1.4,0.1%
Andrey Santos,8,8,6,7,4,7,32,1.4,0.4%
Kovačić,0,0,0,0,13,16,29,1.0,0.0%
Soler,4,4,6,6,8,7,31,1.6,0.3%
Hill,3,3,5,10,8,7,33,1.6,0.7%
Bamford,1,1,2,2,4,4,13,0.5,3.0%
Zinchenko,3,3,4,5,6,6,24,1.0,0.3%
Hayden,1,1,3,4,6,3,17,0.8,0.1%
H.Bueno,1,1,4,3,5,7,20,0.9,0.1%
Raheem Sterling,3,3,1,2,4,3,13,0.0,0.0%
Krafth,1,1,4,5,11,10,31,1.4,0.1%
Davies,2,2,5,7,9,9,32,1.4,0.1%
Mamardashvili,0,0,1,7,6,12,26,1.2,0.6%
George,4,4,2,1,2,2,11,0.4,0.1%
Sima,1,1,3,2,2,2,10,0.4,0.0%
Martinez,0,0,0,0,2,30,32,1.3,0.6%
Hjelde,0,0,0,0,12,22,34,1.7,0.0%
Pedro Lima,3,3,5,5,6,8,27,1.4,1.4%
Jordan,2,2,4,5,9,14,34,1.7,0.2%
Barnes,1,1,1,2,2,3,9,0.4,4.4%
Coleman,1,1,4,4,4,8,21,0.9,0.1%
Alex Moreno,3,3,3,2,4,8,20,1.0,11.2%
Browne,2,2,3,4,3,3,15,0.7,0.1%
Trafford,1,1,5,5,5,6,22,0.9,3.1%
Carney Chukwuemeka,1,1,1,2,2,3,9,0.0,0.0%
Neto,4,4,6,3,4,6,23,1.0,1.1%
Gelhardt,0,0,1,1,3,3,8,0.4,0.3%
Jörgensen,2,2,1,4,4,9,20,0.9,0.2%
Acheampong,3,3,4,3,5,3,18,0.9,0.3%
Kuol,2,2,3,1,1,1,8,0.4,0.1%
Holding,3,3,3,5,5,5,21,1.1,0.3%
Weiss,3,3,2,3,6,6,20,0.9,0.2%
Collyer,1,1,2,3,3,4,13,0.6,0.2%
Triantis,2,2,6,4,3,0,15,0.7,0.1%
B.Badiashile,0,0,0,0,7,14,21,0.9,0.1%
J.Rak-Sakyi,0,0,1,2,2,2,7,0.3,0.1%
Peart-Harris,0,0,1,2,2,2,7,0.3,0.0%
Greenwood,0,0,1,1,1,3,6,0.2,0.1%
Reed,0,0,0,2,3,4,9,0.4,0.3%
Bajcetic,0,0,0,1,4,4,9,0.4,0.1%
Schmidt,1,1,2,5,3,6,17,0.8,0.3%
O’Reilly,0,0,1,1,2,3,7,0.3,0.2%
Faivre,1,1,1,1,1,3,7,0.3,0.2%
Kostoulas,2,2,0,1,1,2,6,0.2,0.6%
J.Cuenca,1,1,3,3,5,4,16,0.7,0.1%
Kinsky,1,1,1,7,2,5,16,0.8,4.1%
Ahamada,0,0,1,1,3,4,9,0.4,0.1%
Arrizabalaga,2,2,2,4,2,5,15,0.7,1.0%
Alese,0,0,0,0,9,10,19,0.9,0.0%
Marshall,0,0,1,1,1,1,4,0.2,0.8%
Jair Cunha,1,1,2,4,4,6,17,0.8,0.1%
Potts,1,1,1,4,3,2,11,0.5,0.7%
Irving,1,1,1,1,1,1,5,0.2,0.3%
David Datro Fofana,2,2,0,1,1,1,5,0.0,0.0%
Patterson,2,2,3,3,2,4,14,0.6,0.5%
M.Sarr,4,4,2,3,4,2,15,0.7,0.1%
Steele,1,1,2,1,1,5,10,0.4,0.4%
Johnstone,1,1,1,2,3,4,11,0.5,0.2%
Darlow,2,2,0,3,3,3,11,0.6,5.7%
Axel Disasi,0,0,3,2,3,2,10,0.0,0.0%
Lecomte,1,1,0,2,3,2,8,0.4,1.1%
Travers,0,0,1,2,3,2,8,0.4,0.2%
Valdimarsson,1,1,2,1,1,2,7,0.3,1.6%
Godo,0,0,0,0,1,1,2,0.1,0.1%
Malacia,0,0,0,1,2,2,5,0.3,0.4%
N.Aguerd,2,2,1,3,2,2,10,0.4,0.1%
Foderingham,1,1,0,1,1,3,6,0.3,0.8%
Ji-soo,1,1,1,2,2,1,7,0.3,0.2%
Delcroix,2,2,1,1,3,2,9,0.5,0.4%
Nelson,0,0,0,1,1,0,2,0.1,0.2%
Amass,1,1,1,1,2,1,6,0.3,0.3%
Armstrong,0,0,1,0,1,4,6,0.3,0.4%
Maghoma,0,0,0,1,1,1,3,0.1,0.1%
Obafemi,0,0,1,0,2,0,3,0.1,0.7%
Neave,1,1,1,0,0,0,2,0.1,0.3%
Renato Veiga,1,1,1,2,0,1,5,0.0,0.0%
Scarlett,0,0,0,0,0,2,2,0.1,0.9%
Sarmiento,1,1,0,0,1,0,2,0.1,0.1%
C.Miguel,1,1,0,0,1,2,4,0.2,0.3%
Boly,0,0,1,0,2,2,5,0.3,0.6%
Winterburn,0,0,2,0,0,0,2,0.1,0.1%
Pond,0,0,1,1,2,0,4,0.2,2.1%
Abbott,0,0,0,1,1,2,4,0.2,0.3%
Konak,0,0,1,1,0,0,2,0.1,0.2%
Gunn,1,1,1,0,1,0,3,0.1,0.3%
R.Williams,0,0,0,1,0,2,3,0.1,0.2%
Kone,0,0,0,0,0,1,1,0.0,0.1%
Moore,0,0,0,0,0,1,1,0.0,0.1%
Fábio Vieira,0,0,0,0,1,0,1,0.0,0.1%
Targett,0,0,1,0,1,0,2,0.1,0.5%
Ben Chilwell,0,0,0,0,1,1,2,0.0,0.0%
Sambi,0,0,0,1,0,0,1,0.0,0.2%
Edozie,0,0,0,0,0,1,1,0.0,0.4%
Anderson,0,0,2,0,1,0,3,0.1,0.6%
Woodman,0,0,0,0,0,1,1,0.1,0.1%
Akinmboni,0,0,0,0,2,0,2,0.1,0.4%
Lascelles,0,0,0,0,1,0,1,0.0,0.1%
Hladký,0,0,0,1,0,0,1,0.1,0.4%
Fredricson,0,0,0,1,0,0,1,0.1,0.2%
Worrall,0,0,0,0,0,1,1,0.1,0.2%
Hein,0,0,0,0,0,0,0,0.0,0.6%
Setford,0,0,0,0,0,0,0,0.0,0.2%
Clarke,0,0,0,0,0,0,0,0.0,0.6%
Kacurri,0,0,0,0,0,0,0,0.0,0.2%
Nichols,0,0,0,0,0,0,0,0.0,0.2%
Kabia,0,0,0,0,0,0,0,0.0,0.3%
G.Jesus,0,0,0,0,0,0,0,0.0,0.0%
Gauci,0,0,0,0,0,0,0,0.0,1.0%
Marschall,0,0,0,0,0,0,0,0.0,0.1%
Sousa,0,0,0,0,0,0,0,0.0,0.3%
Yasin,0,0,0,0,0,0,0,0.0,0.3%
Buendía,0,0,0,0,0,0,0,0.0,0.1%
Iling Jr,0,0,0,0,0,0,0,0.0,0.0%
Barrenechea,0,0,0,0,0,0,0,0.0,0.0%
Dobbin,0,0,0,0,0,0,0,0.0,0.1%
Broggio,0,0,0,0,0,0,0,0.0,0.3%
Dendoncker,0,0,0,0,0,0,0,0.0,0.4%
Jimoh-Aloba,0,0,0,0,0,0,0,0.0,0.1%
Young,0,0,0,0,0,0,0,0.0,0.6%
Redmond,0,0,0,0,0,0,0,0.0,0.9%
Dennis,0,0,0,0,0,0,0,0.0,0.7%
McKenna,0,0,0,0,0,0,0,0.0,0.2%
Paulsen,0,0,0,0,0,0,0,0.0,0.2%
Bevan,0,0,0,0,0,0,0,0.0,0.3%
Sadi,0,0,0,0,0,0,0,0.0,0.1%
Silcott-Duberry,0,0,0,0,0,0,0,0.0,0.2%
Enes Ünal,0,0,0,0,0,0,0,0.0,0.0%
Adu-Adjei,0,0,0,0,0,0,0,0.0,0.4%
Balcombe,0,0,0,0,0,0,0,0.0,0.3%
Cox,0,0,0,0,0,0,0,0.0,0.2%
Eyestone,0,0,0,0,0,0,0,0.0,0.1%
Arthur,0,0,0,0,0,0,0,0.0,0.4%
Fredrick,0,0,0,0,0,0,0,0.0,0.2%
Meghoma,0,0,0,0,0,0,0,0.0,0.2%
Onyeka,0,0,0,0,0,0,0,0.0,0.1%
Donovan,0,0,0,0,0,0,0,0.0,0.1%
Trevitt,0,0,0,0,0,0,0,0.0,0.1%
Morgan,0,0,0,0,0,0,0,0.0,0.5%
McGill,0,0,0,0,0,0,0,0.0,0.3%
Rushworth,0,0,0,0,0,0,0,0.0,0.0%
Scherpen,0,0,0,0,0,0,0,0.0,0.0%
Estupiñan,0,0,0,0,0,0,0,0.0,0.2%
Webster,0,0,0,0,0,0,0,0.0,0.1%
Cashin,0,0,0,0,0,0,0,0.0,0.1%
Slater,0,0,0,0,0,0,0,0.0,0.2%
Tasker,0,0,0,0,0,0,0,0.0,0.2%
Enciso,0,0,0,0,0,0,0,0.0,0.2%
Milner,0,0,0,0,0,0,0,0.0,0.1%
Yalcouye,0,0,0,0,0,0,0,0.0,0.1%
Knight,0,0,0,0,0,0,0,0.0,0.1%
Mazilu,0,0,0,0,0,0,0,0.0,0.1%
Moran,0,0,0,0,0,0,0,0.0,0.1%
Ferguson,0,0,0,0,0,0,0,0.0,0.1%
Green,0,0,0,0,0,0,0,0.0,0.4%
Dodgson,0,0,0,0,0,0,0,0.0,0.2%
Sambo,0,0,0,0,0,0,0,0.0,0.2%
Sonne,0,0,0,0,0,0,0,0.0,0.2%
Boateng,0,0,0,0,0,0,0,0.0,0.1%
Churlinov,0,0,0,0,0,0,0,0.0,0.1%
Adewumi,0,0,0,0,0,0,0,0.0,0.1%
Banel,0,0,0,0,0,0,0,0.0,0.0%
Trésor,0,0,0,0,0,0,0,0.0,0.1%
Penders,0,0,0,0,0,0,0,0.0,0.0%
Slonina,0,0,0,0,0,0,0,0.0,0.1%
Colwill,0,0,0,0,0,0,0,0.0,3.5%
Anselmino,0,0,0,0,0,0,0,0.0,0.2%
Mudryk,0,0,0,0,0,0,0,0.0,0.0%
Paez,0,0,0,0,0,0,0,0.0,0.1%
Matthews,0,0,0,0,0,0,0,0.0,0.1%
Chadi Riad,0,0,0,0,0,0,0,0.0,0.0%
Kporha,0,0,0,0,0,0,0,0.0,0.2%
Doucouré,0,0,0,0,0,0,0,0.0,0.0%
Agbinone,0,0,0,0,0,0,0,0.0,0.1%
Ebiowei,0,0,0,0,0,0,0,0.0,0.1%
Ozoh,0,0,0,0,0,0,0,0.0,0.0%
Rodney,0,0,0,0,0,0,0,0.0,0.0%
Umeh,0,0,0,0,0,0,0,0.0,0.0%
Nketiah,0,0,0,0,0,0,0,0.0,1.6%
Marsh,0,0,0,0,0,0,0,0.0,0.3%
Tyrer,0,0,0,0,0,0,0,0.0,0.2%
Dixon,0,0,0,0,0,0,0,0.0,0.3%
Welch,0,0,0,0,0,0,0,0.0,0.2%
Bates,0,0,0,0,0,0,0,0.0,0.1%
Ebere,0,0,0,0,0,0,0,0.0,0.0%
Heath,0,0,0,0,0,0,0,0.0,0.0%
Metcalfe,0,0,0,0,0,0,0,0.0,0.0%
Sherif,0,0,0,0,0,0,0,0.0,0.3%
Benda,0,0,0,0,0,0,0,0.0,0.1%
Amissah,0,0,0,0,0,0,0,0.0,0.2%
Harris,0,0,0,0,0,0,0,0.0,0.0%
Meslier,0,0,0,0,0,0,0,0.0,1.0%
Cairns,0,0,0,0,0,0,0,0.0,0.3%
Crew,0,0,0,0,0,0,0,0.0,0.1%
Gyabi,0,0,0,0,0,0,0,0.0,0.1%
Mateo Joseph,0,0,0,0,0,0,0,0.0,0.2%
Pécsi,0,0,0,0,0,0,0,0.0,0.1%
Nallo,0,0,0,0,0,0,0,0.0,0.2%
Ramsay,0,0,0,0,0,0,0,0.0,0.2%
Luis Díaz,0,0,0,0,0,0,0,0.0,0.7%
Doak,0,0,0,0,0,0,0,0.0,0.1%
McConnell,0,0,0,0,0,0,0,0.0,0.0%
Morton,0,0,0,0,0,0,0,0.0,0.0%
Nyoni,0,0,0,0,0,0,0,0.0,0.1%
Darwin,0,0,0,0,0,0,0,0.0,1.2%
Danns,0,0,0,0,0,0,0,0.0,0.2%
Ortega Moreno,0,0,0,0,0,0,0,0.0,0.4%
Bettinelli,0,0,0,0,0,0,0,0.0,0.2%
Vitor Reis,0,0,0,0,0,0,0,0.0,0.1%
Echeverri,0,0,0,0,0,0,0,0.0,0.1%
Nypan,0,0,0,0,0,0,0,0.0,0.1%
Phillips,0,0,0,0,0,0,0,0.0,0.1%
Harrison,0,0,0,0,0,0,0,0.0,0.0%
Heaton,0,0,0,0,0,0,0,0.0,0.4%
Mee,0,0,0,0,0,0,0,0.0,0.1%
D.Leon,0,0,0,0,0,0,0,0.0,0.1%
Rashford,0,0,0,0,0,0,0,0.0,0.3%
Garnacho,0,0,0,0,0,0,0,0.0,0.2%
Antony,0,0,0,0,0,0,0,0.0,0.1%
Sancho,0,0,0,0,0,0,0,0.0,0.1%
Fitzgerald,0,0,0,0,0,0,0,0.0,0.0%
J.Fletcher,0,0,0,0,0,0,0,0.0,0.0%
Moorhouse,0,0,0,0,0,0,0,0.0,0.0%
Wheatley,0,0,0,0,0,0,0,0.0,0.2%
Gillespie,0,0,0,0,0,0,0,0.0,0.1%
Odysseas,0,0,0,0,0,0,0,0.0,0.1%
A.Murphy,0,0,0,0,0,0,0,0.0,0.8%
Ashby,0,0,0,0,0,0,0,0.0,0.2%
Pivas,0,0,0,0,0,0,0,0.0,0.2%
Antoñito C.,0,0,0,0,0,0,0,0.0,0.1%
White,0,0,0,0,0,0,0,0.0,0.1%
Turner,0,0,0,0,0,0,0,0.0,1.3%
David Carmo,0,0,0,0,0,0,0,0.0,0.1%
Dominguez,0,0,0,0,0,0,0,0.0,0.0%
O'Brien,0,0,0,0,0,0,0,0.0,0.0%
Moore,0,0,0,0,0,0,0,0.0,0.6%
Nna Noukeu,0,0,0,0,0,0,0,0.0,0.2%
Cirkin,0,0,0,0,0,0,0,0.0,0.2%
Johnson,0,0,0,0,0,0,0,0.0,0.3%
Aleksić,0,0,0,0,0,0,0,0.0,0.1%
Ba,0,0,0,0,0,0,0,0.0,0.4%
H.Jones,0,0,0,0,0,0,0,0.0,0.1%
Matete,0,0,0,0,0,0,0,0.0,0.3%
Abdullahi,0,0,0,0,0,0,0,0.0,1.0%
Luís Hemir,0,0,0,0,0,0,0,0.0,0.3%
Rusyn,0,0,0,0,0,0,0,0.0,0.3%
Austin,0,0,0,0,0,0,0,0.0,0.3%
Dragusin,0,0,0,0,0,0,0,0.0,0.0%
Phillips,0,0,0,0,0,0,0,0.0,0.1%
Takai,0,0,0,0,0,0,0,0.0,0.4%
Vuskovic,0,0,0,0,0,0,0,0.0,2.0%
Son,0,0,0,0,0,0,0,0.0,1.9%
Maddison,0,0,0,0,0,0,0,0.0,2.3%
Kulusevski,0,0,0,0,0,0,0,0.0,0.0%
Min-hyeok,0,0,0,0,0,0,0,0.0,0.2%
Olusesi,0,0,0,0,0,0,0,0.0,0.2%
Lankshear,0,0,0,0,0,0,0,0.0,0.4%
Hegyi,0,0,0,0,0,0,0,0.0,0.4%
Casey,0,0,0,0,0,0,0,0.0,0.8%
Earthy,0,0,0,0,0,0,0,0.0,0.2%
Orford,0,0,0,0,0,0,0,0.0,0.2%
Bentley,0,0,0,0,0,0,0,0.0,1.1%
King,0,0,0,0,0,0,0,0.0,2.5%
Meupiyou,0,0,0,0,0,0,0,0.0,0.1%
Guedes,0,0,0,0,0,0,0,0.0,0.1%
B.Traore,0,0,0,0,0,0,0,0.0,0.0%
Chirewa,0,0,0,0,0,0,0,0.0,0.3%
Gonzalez,0,0,0,0,0,0,0,0.0,1.4%
Hodge,0,0,0,0,0,0,0,0.0,0.3%
Chiwome,0,0,0,0,0,0,0,0.0,0.1%
Fraser,0,0,0,0,0,0,0,0.0,2.6%
Josh Wilson-Esbrand,0,0,0,0,0,0,0,0.0,0.0%
Issa Kaboré,0,0,0,0,0,0,0,0.0,0.0%
Alfie Gilchrist,0,0,0,0,0,0,0,0.0,0.0%
Emmanuel Dennis,0,0,0,0,0,0,0,0.0,0.0%
Hindolo Mustapha,0,0,0,0,0,0,0,0.0,0.0%
Callum Doyle,0,0,0,0,0,0,0,0.0,0.0%
